ags,t,m,f,ags,pwi,pwa,pwn,pan,paa,ai,aa,an,wi,wa,wn,pai,pwi_h,pwa_h,pwn_h,search
05111000,612178,295896,316282,05111000,8.9,5.8,3.1,4.0,7.8,72031,47574,24457,54669,35525,19144,11.8,"6.7,8.5,8.6,8.9,9.1,9.2,9.3,9.3,9.4,9.4,9.2,9.1,8.9","5.0,5.9,5.9,6.0,6.0,6.0,6.1,6.0,6.0,5.9,6.1,6.0,5.8","1.7,2.6,2.7,2.9,3.1,3.2,3.3,3.3,3.4,3.4,3.1,3.1,3.1","düsseldorf, stadt"
05112000,491231,241417,249814,05112000,8.5,6.3,2.2,1.9,5.5,36694,27259,9435,41813,31151,10662,7.5,"6.7,7.9,8.1,8.3,8.6,8.7,8.8,8.8,8.9,8.9,8.7,8.8,8.5","5.7,6.3,6.3,6.5,6.5,6.5,6.6,6.5,6.5,6.5,6.6,6.7,6.3","1.0,1.6,1.7,1.8,2.0,2.2,2.3,2.3,2.4,2.4,2.1,2.2,2.2","duisburg, stadt"
05113000,582624,282565,300059,05113000,8.7,6.4,2.3,2.8,7.6,60185,44104,16081,50674,37211,13463,10.3,"6.5,7.8,7.8,8.1,8.3,8.5,8.8,8.9,9.0,9.1,8.9,9.0,8.7","5.4,6.0,6.0,6.2,6.2,6.3,6.4,6.5,6.5,6.5,6.7,6.7,6.4","1.1,1.8,1.8,2.0,2.1,2.3,2.4,2.5,2.6,2.6,2.2,2.3,2.3","essen, stadt"
05114000,225144,109487,115657,05114000,9.7,6.8,2.9,2.8,6.3,20602,14291,6311,21928,15373,6555,9.2,"6.9,8.4,8.4,8.8,9.1,9.4,9.5,9.6,9.6,10.1,9.9,9.9,9.7","5.5,6.3,6.3,6.4,6.6,6.7,6.7,6.7,6.6,6.9,7.1,7.0,6.8","1.3,2.0,2.2,2.4,2.5,2.7,2.7,2.8,2.9,3.2,2.8,2.9,2.9","krefeld, stadt"
05116000,259996,127512,132484,05116000,10.3,7.1,3.2,3.2,7.6,28082,19638,8444,26669,18472,8197,10.8,"7.4,9.0,9.0,9.4,9.7,9.9,10.1,10.2,10.5,10.5,10.5,10.4,10.3","6.0,6.9,6.8,7.0,7.1,7.1,7.2,7.2,7.3,7.2,7.5,7.3,7.1","1.4,2.1,2.3,2.4,2.6,2.9,2.9,3.0,3.3,3.3,3.0,3.1,3.2","mönchengladbach, stadt"
05117000,169278,81461,87817,05117000,8.7,6.2,2.5,2.5,6.7,15589,11307,4282,14694,10465,4229,9.2,"6.9,8.2,8.3,8.6,8.8,9.0,9.3,9.4,9.3,9.3,9.1,9.0,8.7","5.6,6.3,6.3,6.5,6.5,6.5,6.7,6.7,6.6,6.5,6.6,6.5,6.2","1.2,1.9,1.9,2.1,2.3,2.5,2.6,2.7,2.8,2.8,2.5,2.5,2.5","mülheim an der ruhr, stadt"
05119000,210934,103284,107650,05119000,9.0,6.7,2.2,2.4,7.1,20051,15028,5023,18889,14196,4693,9.5,"6.9,8.2,8.2,8.5,8.7,8.9,9.2,9.3,9.4,9.3,9.3,9.3,9.0","5.9,6.5,6.5,6.6,6.6,6.7,6.9,6.9,6.9,6.9,7.1,7.1,6.7","1.1,1.6,1.7,1.9,2.1,2.2,2.3,2.4,2.5,2.5,2.2,2.2,2.2","oberhausen, stadt"
05120000,109499,53725,55774,05120000,10.5,6.9,3.5,3.6,7.2,11750,7852,3898,11448,7570,3878,10.7,"8.3,9.8,9.7,10.3,10.6,10.8,10.4,10.9,11.0,10.8,10.6,10.7,10.5","6.3,7.0,6.9,7.1,7.2,7.3,7.1,7.4,7.3,7.0,7.1,7.1,6.9","2.0,2.8,2.9,3.2,3.4,3.6,3.4,3.4,3.8,3.8,3.5,3.6,3.5","remscheid, stadt"
05122000,158726,76948,81778,05122000,9.8,6.4,3.4,3.1,5.7,13891,9044,4847,15546,10121,5425,8.8,"7.5,9.0,8.9,9.3,9.7,10.0,9.6,9.8,10.0,10.1,10.0,10.2,9.8","5.8,6.5,6.3,6.5,6.6,6.7,6.5,6.6,6.5,6.5,6.7,6.8,6.4","1.7,2.5,2.6,2.8,3.0,3.3,3.1,3.2,3.4,3.6,3.3,3.4,3.4","solingen, klingenstadt"
05124000,350046,170822,179224,05124000,9.5,6.6,2.9,2.8,6.6,32897,22974,9923,33360,23110,10250,9.4,"7.3,8.6,8.7,9.1,9.4,9.6,9.7,9.7,9.8,10.0,9.8,9.8,9.5","5.7,6.3,6.4,6.5,6.6,6.7,6.8,6.7,6.6,6.7,7.0,6.9,6.6","1.6,2.3,2.4,2.6,2.8,3.0,2.9,3.1,3.2,3.2,2.8,2.9,2.9","wuppertal, stadt"
05154004,13033,6701,6332,05154004,9.9,6.7,3.2,2.3,5.4,1001,700,301,1292,870,422,7.7,"7.2,9.1,9.3,9.6,10.2,10.1,10.2,10.0,10.1,10.7,10.4,10.3,9.9","5.9,7.0,7.0,7.2,7.5,7.3,7.2,7.0,7.1,7.4,7.3,7.1,6.7","1.3,2.1,2.3,2.4,2.7,2.9,3.1,3.1,3.0,3.3,3.1,3.2,3.2",bedburg-hau
05154008,30968,15705,15263,05154008,9.7,7.3,2.5,2.4,7.3,2999,2271,728,3011,2250,761,9.7,"8.8,9.9,10.2,10.7,10.8,10.8,10.8,10.5,10.6,10.4,10.4,10.5,9.7","7.4,7.9,8.1,8.3,8.3,8.1,8.0,7.8,7.8,7.6,8.0,8.0,7.3","1.4,2.0,2.1,2.4,2.6,2.7,2.8,2.7,2.7,2.8,2.4,2.5,2.5","emmerich am rhein, stadt"
05154012,33841,17037,16804,05154012,11.1,7.8,3.3,4.1,10.5,4960,3569,1391,3770,2648,1122,14.7,"9.2,10.7,10.7,11.6,11.6,12.0,12.3,12.3,12.3,12.5,12.3,12.1,11.1","7.6,8.4,8.2,8.7,8.5,8.7,8.7,8.7,8.7,8.7,9.0,8.6,7.8","1.5,2.3,2.5,3.0,3.1,3.3,3.6,3.6,3.6,3.8,3.3,3.4,3.3","geldern, stadt"
05154016,33889,16990,16899,05154016,11.1,7.7,3.3,3.0,7.0,3422,2389,1033,3745,2626,1119,10.1,"8.7,10.0,10.1,10.4,10.8,11.1,11.4,11.4,11.3,11.7,11.8,11.7,11.1","7.3,8.0,8.0,8.0,8.2,8.3,8.4,8.3,8.2,8.3,8.6,8.4,7.7","1.4,2.0,2.2,2.4,2.6,2.8,3.0,3.1,3.1,3.4,3.2,3.3,3.3","goch, stadt"
05154020,12037,5896,6141,05154020,11.0,7.9,3.1,2.0,5.9,960,715,245,1321,953,368,8.0,"8.4,10.2,10.0,10.6,10.8,11.1,11.4,11.5,11.7,11.4,11.3,11.4,11.0","7.0,8.1,8.0,8.2,8.3,8.4,8.5,8.5,8.4,8.2,8.6,8.6,7.9","1.3,2.1,2.0,2.4,2.5,2.6,2.8,3.0,3.3,3.2,2.7,2.8,3.1",issum
05154024,13854,6884,6970,05154024,12.8,9.3,3.5,4.0,9.0,1793,1243,550,1775,1291,484,12.9,"9.5,10.9,11.0,11.3,12.0,12.0,12.8,12.8,13.2,13.2,13.2,13.4,12.8","8.0,8.7,8.6,8.6,9.1,9.0,9.6,9.3,9.4,9.3,9.8,10.0,9.3","1.6,2.2,2.3,2.7,2.9,3.0,3.2,3.5,3.8,3.9,3.4,3.4,3.5","kalkar, stadt"
05154028,13262,6670,6592,05154028,10.1,7.2,2.9,2.2,5.8,1069,774,295,1338,957,381,8.1,"8.3,9.9,10.0,10.3,10.7,11.0,11.2,11.8,11.3,11.3,10.9,11.3,10.1","7.0,7.7,7.8,7.9,8.1,8.3,8.4,8.5,8.2,8.3,8.0,8.3,7.2","1.4,2.1,2.3,2.4,2.6,2.7,2.8,3.2,3.1,3.0,3.0,3.0,2.9",kerken
05154032,28311,13925,14386,05154032,11.8,8.5,3.3,3.2,8.1,3183,2291,892,3334,2394,940,11.2,"9.3,10.9,11.1,11.6,12.0,12.5,12.8,12.9,12.7,12.9,12.9,12.9,11.8","7.8,8.8,8.8,9.0,9.1,9.4,9.7,9.5,9.5,9.3,9.5,9.4,8.5","1.5,2.1,2.3,2.6,2.9,3.1,3.2,3.4,3.3,3.6,3.4,3.6,3.3","kevelaer, stadt"
05154036,49729,24457,25272,05154036,10.8,7.7,3.1,3.9,9.3,6561,4641,1920,5385,3849,1536,13.2,"8.4,9.9,10.0,10.4,10.6,10.9,10.7,10.6,10.8,11.2,11.2,11.2,10.8","6.9,7.7,7.7,7.9,8.0,8.0,7.8,7.7,7.7,7.9,8.2,8.1,7.7","1.5,2.2,2.3,2.5,2.6,2.9,2.9,2.9,3.1,3.3,3.0,3.1,3.1","kleve, stadt"
05154040,10648,5444,5204,05154040,10.0,6.9,3.0,3.1,5.6,923,594,329,1061,740,321,8.7,"7.6,9.1,9.1,9.7,9.6,9.9,9.7,9.9,10.1,10.4,10.3,10.5,10.0","6.6,7.2,7.1,7.2,7.2,7.3,7.0,6.9,7.0,7.0,7.1,7.2,6.9","1.0,1.9,2.0,2.5,2.4,2.5,2.7,2.9,3.1,3.4,3.2,3.2,3.0",kranenburg
05154044,21349,10608,10741,05154044,12.1,8.9,3.2,2.3,6.5,1875,1390,485,2581,1895,686,8.8,"8.9,10.0,9.9,10.5,11.0,11.1,11.3,11.5,11.9,12.1,12.2,12.2,12.1","7.5,7.9,7.9,8.2,8.6,8.5,8.5,8.5,8.7,8.9,9.2,9.1,8.9","1.5,2.1,2.0,2.3,2.4,2.7,2.8,3.0,3.2,3.2,3.0,3.0,3.2","rees, stadt"
05154048,6709,3327,3382,05154048,9.5,7.0,2.5,1.4,4.5,394,299,95,636,467,169,5.9,"6.6,8.5,9.1,9.4,9.5,9.0,9.2,9.5,9.7,9.6,9.8,9.8,9.5","5.6,6.7,7.2,7.2,7.0,6.6,7.0,7.1,7.2,7.1,7.5,7.3,7.0","1.1,1.8,1.9,2.2,2.5,2.4,2.2,2.4,2.5,2.6,2.3,2.5,2.5",rheurdt
05154052,15641,7768,7873,05154052,12.7,8.6,4.2,4.2,8.6,2012,1351,661,1993,1341,652,12.9,"10.5,12.8,12.6,13.1,13.1,13.2,13.8,13.9,14.5,14.0,14.0,13.8,12.7","8.5,9.7,9.5,9.5,9.5,9.4,9.7,9.7,9.9,9.3,9.4,9.2,8.6","2.0,3.1,3.1,3.6,3.6,3.8,4.1,4.3,4.6,4.7,4.6,4.6,4.2","straelen, stadt"
05154056,8266,4111,4155,05154056,11.5,7.9,3.6,2.6,6.3,730,517,213,950,649,301,8.8,"8.2,9.9,10.3,10.5,10.7,11.2,11.7,12.4,12.7,12.3,12.3,12.3,11.5","7.1,8.0,8.0,7.9,7.7,8.3,8.4,8.9,8.8,8.4,8.8,8.7,7.9","1.1,1.9,2.3,2.5,2.9,2.9,3.3,3.6,3.9,3.9,3.5,3.6,3.6",uedem
05154060,8189,4115,4074,05154060,11.1,7.7,3.4,3.2,7.5,876,613,263,913,632,281,10.7,"8.5,9.8,10.3,11.1,11.1,12.0,12.5,11.9,11.4,11.6,11.8,11.7,11.1","7.3,7.9,7.9,8.5,7.9,8.4,9.1,8.5,7.9,7.9,8.4,8.3,7.7","1.3,1.9,2.4,2.6,3.2,3.6,3.4,3.4,3.5,3.7,3.5,3.4,3.4",wachtendonk
05154064,10611,5350,5261,05154064,10.9,8.1,2.8,2.9,5.8,918,615,303,1159,861,298,8.7,"9.3,10.8,11.4,11.6,11.3,11.5,11.8,11.8,11.1,11.7,11.9,11.8,10.9","8.1,8.8,9.5,9.5,9.0,8.8,8.9,8.8,8.1,8.8,9.0,8.8,8.1","1.2,2.0,2.0,2.1,2.3,2.7,3.0,3.0,3.0,3.0,2.9,3.0,2.8",weeze
05158004,44086,21054,23032,05158004,9.9,6.7,3.2,3.2,6.5,4252,2849,1403,4349,2959,1390,9.6,"6.8,8.2,8.4,8.7,9.0,9.5,9.8,9.7,9.8,10.4,10.0,10.0,9.9","5.3,6.1,6.1,6.2,6.3,6.5,6.9,6.8,6.7,6.9,6.9,6.9,6.7","1.5,2.2,2.4,2.5,2.7,3.0,2.9,3.0,3.2,3.5,3.1,3.1,3.2","erkrath, fundort des neanderthalers, stadt"
05158008,30410,14579,15831,05158008,9.3,6.3,3.0,3.4,6.0,2849,1829,1020,2817,1910,907,9.4,"7.4,8.9,8.8,9.1,9.4,9.8,9.8,9.7,10.0,9.8,9.5,9.7,9.3","5.9,6.6,6.3,6.6,6.5,6.6,6.5,6.6,6.8,6.5,6.4,6.6,6.3","1.5,2.4,2.5,2.5,2.9,3.2,3.2,3.1,3.2,3.3,3.1,3.2,3.0","haan, stadt"
05158012,25793,12654,13139,05158012,10.1,6.5,3.6,2.8,5.4,2108,1394,714,2610,1677,933,8.2,"8.0,9.4,9.5,10.0,10.5,10.8,10.0,10.6,10.5,10.6,10.7,10.5,10.1","6.2,6.7,6.8,6.9,7.1,7.2,6.9,7.1,6.8,6.8,7.0,7.0,6.5","1.9,2.7,2.7,3.1,3.5,3.7,3.2,3.5,3.7,3.8,3.6,3.6,3.6","heiligenhaus, stadt"
05158016,55185,26620,28565,05158016,9.8,6.4,3.5,3.6,6.8,5777,3774,2003,5435,3506,1929,10.5,"7.4,8.6,9.1,9.2,9.6,9.9,10.0,10.1,10.2,10.4,10.3,10.3,9.8","5.6,6.1,6.3,6.2,6.3,6.4,6.5,6.6,6.5,6.5,6.8,6.7,6.4","1.8,2.5,2.8,3.0,3.3,3.5,3.5,3.6,3.6,3.9,3.6,3.6,3.5","hilden, stadt"
05158020,58033,28239,29794,05158020,9.3,6.1,3.1,3.9,7.3,6525,4264,2261,5384,3567,1817,11.2,"6.7,8.1,8.3,8.7,9.0,9.1,9.2,9.4,9.5,9.8,9.7,9.8,9.3","5.4,6.0,6.0,6.2,6.3,6.3,6.3,6.4,6.3,6.4,6.6,6.6,6.1","1.3,2.1,2.3,2.5,2.7,2.8,2.8,3.0,3.2,3.4,3.1,3.1,3.1","langenfeld (rheinland), stadt"
05158024,38291,18413,19878,05158024,9.0,6.2,2.8,2.6,5.6,3124,2132,992,3460,2376,1084,8.2,"6.4,7.8,7.9,8.3,8.4,8.6,8.6,8.9,9.1,9.5,9.4,9.4,9.0","5.1,5.9,5.8,6.1,6.1,6.0,5.9,6.0,6.0,6.4,6.4,6.4,6.2","1.2,1.9,2.1,2.2,2.3,2.7,2.8,2.8,3.0,3.1,2.9,3.0,2.8","mettmann, stadt"
05158026,40885,19650,21235,05158026,9.8,6.7,3.2,2.1,4.4,2673,1805,868,4026,2736,1290,6.5,"7.2,8.6,8.6,9.2,9.4,9.8,9.8,9.6,10.0,10.8,10.3,10.3,9.8","5.8,6.4,6.3,6.6,6.6,6.6,6.7,6.4,6.6,7.0,7.1,7.1,6.7","1.4,2.2,2.3,2.6,2.8,3.1,3.2,3.2,3.4,3.8,3.2,3.2,3.2","monheim am rhein, stadt"
05158028,87943,42217,45726,05158028,9.7,6.4,3.3,3.3,6.5,8656,5720,2936,8521,5644,2877,9.8,"7.0,8.3,8.7,9.1,9.4,9.6,9.6,9.6,9.6,10.1,10.1,10.0,9.7","5.5,6.0,6.2,6.3,6.4,6.4,6.5,6.4,6.4,6.7,6.8,6.8,6.4","1.6,2.3,2.5,2.8,2.9,3.2,3.1,3.2,3.2,3.5,3.2,3.2,3.3","ratingen, stadt"
05158032,81430,39660,41770,05158032,10.1,6.6,3.4,3.2,6.7,8060,5420,2640,8202,5400,2802,9.9,"7.7,9.3,9.4,9.9,10.4,10.5,10.1,10.3,10.4,10.6,10.7,10.7,10.1","5.9,6.7,6.6,6.7,7.0,7.1,6.9,6.9,6.8,6.9,7.3,7.3,6.6","1.8,2.6,2.7,3.1,3.4,3.5,3.2,3.4,3.6,3.7,3.4,3.5,3.4","velbert, stadt"
05158036,21223,10362,10861,05158036,9.7,6.6,3.1,2.6,5.9,1798,1248,550,2064,1399,665,8.5,"7.3,8.5,8.9,9.3,9.7,9.9,9.8,10.0,10.2,10.3,10.1,10.1,9.7","5.7,6.2,6.5,6.6,6.8,6.9,6.8,7.0,7.0,7.0,7.0,6.9,6.6","1.5,2.3,2.4,2.7,2.9,3.0,2.9,3.0,3.2,3.3,3.1,3.3,3.1","wülfrath, stadt"
05162004,64064,31816,32248,05162004,8.9,6.1,2.8,2.2,4.8,4487,3094,1393,5692,3926,1766,7.0,"7.1,8.1,8.2,8.5,8.7,8.8,9.0,9.2,9.3,9.3,9.2,9.1,8.9","5.8,6.2,6.2,6.3,6.3,6.3,6.4,6.5,6.4,6.3,6.5,6.4,6.1","1.3,1.9,2.0,2.1,2.4,2.5,2.6,2.7,2.9,3.0,2.7,2.8,2.8","dormagen, stadt"
05162008,63051,30723,32328,05162008,9.5,6.6,2.9,2.4,5.4,4941,3432,1509,6007,4147,1860,7.8,"7.0,8.3,8.6,8.8,9.0,9.4,9.6,9.7,10.1,10.3,10.1,10.0,9.5","5.6,6.2,6.3,6.4,6.5,6.7,6.9,6.9,7.0,7.1,7.1,7.1,6.6","1.4,2.1,2.2,2.4,2.5,2.7,2.7,2.9,3.1,3.2,3.0,2.9,2.9","grevenbroich, stadt"
05162012,23260,11590,11670,05162012,9.3,6.5,2.8,2.9,6.3,2123,1455,668,2172,1519,653,9.1,"7.2,8.2,8.2,8.3,8.5,8.9,9.2,9.3,9.3,9.5,9.6,9.6,9.3","6.0,6.4,6.4,6.4,6.5,6.6,6.8,6.8,6.6,6.7,6.8,6.8,6.5","1.2,1.8,1.8,1.9,2.0,2.2,2.4,2.5,2.7,2.8,2.8,2.7,2.8",jüchen
05162016,43286,20812,22474,05162016,8.6,5.8,2.8,2.3,5.1,3180,2195,985,3729,2531,1198,7.3,"6.9,8.4,8.4,8.6,9.0,9.2,9.4,9.1,9.3,9.2,9.2,8.9,8.6","5.5,6.2,6.2,6.2,6.3,6.4,6.5,6.3,6.3,6.1,6.3,6.1,5.8","1.3,2.2,2.2,2.4,2.6,2.8,2.9,2.8,3.1,3.1,2.8,2.8,2.8","kaarst, stadt"
05162020,32922,16085,16837,05162020,9.0,6.3,2.7,2.6,5.7,2709,1868,841,2953,2067,886,8.2,"6.5,7.7,8.0,8.3,8.7,8.8,9.0,8.8,9.2,9.6,9.4,9.5,9.0","5.2,5.8,6.0,6.1,6.3,6.2,6.3,6.1,6.2,6.5,6.4,6.5,6.3","1.2,1.8,2.0,2.3,2.5,2.6,2.7,2.7,3.0,3.1,2.9,3.0,2.7","korschenbroich, stadt"
05162022,54892,26183,28709,05162022,8.5,5.8,2.7,2.7,5.6,4570,3066,1504,4692,3199,1493,8.3,"6.1,7.4,7.6,8.1,8.4,8.6,8.6,8.8,8.9,8.9,8.8,8.8,8.5","4.8,5.6,5.6,5.8,6.0,6.0,6.0,6.1,6.1,6.0,6.1,6.1,5.8","1.2,1.8,2.1,2.2,2.4,2.6,2.6,2.7,2.8,2.8,2.6,2.7,2.7","meerbusch, stadt"
05162024,155414,75929,79485,05162024,9.8,6.4,3.3,3.0,6.1,14161,9535,4626,15158,10019,5139,9.1,"7.7,9.1,9.4,9.7,10.0,10.0,10.1,10.1,10.2,10.3,10.1,10.1,9.8","6.1,6.7,6.8,6.9,6.9,6.8,6.8,6.7,6.7,6.7,6.8,6.7,6.4","1.6,2.4,2.6,2.8,3.0,3.2,3.2,3.3,3.5,3.6,3.3,3.4,3.3","neuss, stadt"
05162028,13137,6512,6625,05162028,8.6,6.0,2.6,2.0,4.0,790,529,261,1131,785,346,6.0,"6.7,7.7,8.0,8.5,8.5,8.6,8.7,8.9,9.3,9.5,9.4,8.9,8.6","5.6,6.1,6.2,6.4,6.4,6.4,6.4,6.5,6.6,6.6,6.6,6.3,6.0","1.1,1.6,1.8,2.1,2.1,2.2,2.3,2.4,2.7,2.9,2.7,2.7,2.6",rommerskirchen
05166004,15648,7677,7971,05166004,11.3,7.6,3.7,3.6,7.0,1657,1098,559,1765,1192,573,10.6,"8.3,9.8,9.8,10.5,11.0,11.2,11.5,11.5,11.6,11.9,11.6,11.8,11.3","6.8,7.6,7.5,7.9,8.0,8.0,8.2,8.2,8.1,8.2,8.1,8.3,7.6","1.5,2.3,2.3,2.6,2.9,3.2,3.3,3.3,3.5,3.7,3.5,3.5,3.7","brüggen, burggemeinde"
05166008,14914,7342,7572,05166008,10.1,6.8,3.3,2.0,5.0,1041,743,298,1509,1016,493,7.0,"7.1,8.4,8.6,9.2,9.3,9.4,10.0,10.0,10.0,10.6,10.6,10.5,10.1","5.7,6.4,6.2,6.6,6.8,6.7,6.9,6.9,6.8,7.0,7.2,7.1,6.8","1.3,2.1,2.4,2.6,2.4,2.8,3.1,3.0,3.2,3.5,3.3,3.4,3.3","grefrath, sport- und freizeitgemeinde"
05166012,34837,16911,17926,05166012,10.2,6.9,3.3,3.8,8.2,4161,2842,1319,3555,2419,1136,11.9,"7.8,9.3,9.5,9.7,9.9,10.3,10.3,10.3,10.5,10.7,10.6,10.5,10.2","6.4,7.0,7.0,7.1,7.2,7.3,7.3,7.1,7.2,7.3,7.4,7.3,6.9","1.4,2.3,2.5,2.7,2.7,3.1,3.0,3.2,3.3,3.4,3.2,3.2,3.3","kempen, stadt"
05166016,41964,20769,21195,05166016,10.6,7.5,3.1,2.7,6.9,4026,2881,1145,4447,3133,1314,9.6,"8.1,9.3,9.6,10.2,10.7,10.9,11.0,11.2,11.3,11.0,11.2,11.3,10.6","6.5,7.0,7.1,7.5,7.8,7.8,7.8,7.8,7.8,7.7,8.0,8.0,7.5","1.6,2.3,2.5,2.8,2.9,3.1,3.2,3.4,3.5,3.3,3.2,3.3,3.1","nettetal, stadt"
05166020,15184,7487,7697,05166020,9.6,6.4,3.2,2.4,4.9,1106,742,364,1454,974,480,7.3,"6.8,8.4,8.6,9.4,9.4,9.8,9.8,9.8,9.9,10.2,10.0,10.1,9.6","5.6,6.4,6.5,6.8,6.7,6.8,6.8,6.6,6.7,6.8,6.9,7.0,6.4","1.2,2.0,2.1,2.5,2.7,3.0,3.0,3.2,3.2,3.3,3.1,3.2,3.2",niederkrüchten
05166024,19139,9441,9698,05166024,9.9,6.8,3.1,3.0,5.5,1637,1059,578,1893,1298,595,8.6,"7.6,9.1,9.5,9.8,10.2,10.5,10.7,10.7,11.0,10.4,10.6,10.7,9.9","6.2,6.9,7.0,7.3,7.6,7.6,7.5,7.4,7.4,7.0,7.3,7.4,6.8","1.4,2.2,2.5,2.5,2.7,3.0,3.2,3.3,3.6,3.4,3.3,3.3,3.1",schwalmtal
05166028,29296,14301,14995,05166028,9.7,6.4,3.3,3.2,6.7,2901,1968,933,2847,1879,968,9.9,"7.1,8.5,8.7,9.0,9.2,9.8,9.8,9.9,9.9,10.0,9.9,10.0,9.7","5.7,6.3,6.2,6.5,6.4,7.0,6.8,6.7,6.6,6.6,6.8,6.7,6.4","1.4,2.2,2.5,2.5,2.7,2.9,3.0,3.2,3.3,3.4,3.1,3.3,3.3","tönisvorst, stadt"
05166032,75931,36727,39204,05166032,9.8,6.8,3.0,2.8,6.3,6864,4758,2106,7412,5132,2280,9.0,"7.4,8.7,8.7,9.2,9.4,9.7,9.8,9.9,9.9,10.0,10.2,10.2,9.8","6.0,6.7,6.6,6.8,6.9,6.9,6.9,7.0,6.9,6.9,7.3,7.1,6.8","1.3,2.1,2.1,2.4,2.5,2.7,2.9,2.9,3.0,3.2,3.0,3.1,3.0","viersen, stadt"
05166036,50748,24815,25933,05166036,9.7,6.5,3.3,3.4,6.5,5002,3277,1725,4947,3286,1661,9.9,"6.7,8.0,8.2,8.5,8.8,8.9,9.4,9.6,9.8,10.0,9.9,10.1,9.7","5.4,6.0,6.1,6.2,6.4,6.2,6.6,6.6,6.6,6.6,6.8,6.8,6.5","1.2,2.0,2.1,2.3,2.4,2.8,2.8,3.0,3.2,3.4,3.1,3.3,3.3","willich, stadt"
05170004,12798,6375,6423,05170004,10.3,7.5,2.9,2.3,6.2,1089,792,297,1321,955,366,8.5,"7.9,9.4,9.1,9.6,10.0,10.2,10.7,10.5,10.8,10.8,10.6,10.4,10.3","6.6,7.4,7.2,7.5,7.6,7.7,7.9,7.7,7.7,7.7,7.7,7.5,7.5","1.3,2.0,1.9,2.1,2.5,2.5,2.7,2.8,3.0,3.1,2.8,2.8,2.9",alpen
05170008,67452,32635,34817,05170008,9.4,7.0,2.4,3.1,9.1,8264,6142,2122,6363,4741,1622,12.3,"6.9,8.1,8.1,8.5,8.7,8.9,9.1,9.2,9.3,9.5,9.5,9.6,9.4","5.8,6.4,6.3,6.6,6.6,6.7,6.8,6.9,6.8,6.9,7.1,7.2,7.0","1.1,1.7,1.8,1.9,2.1,2.2,2.3,2.3,2.5,2.5,2.4,2.5,2.4","dinslaken, stadt"
05170012,26996,13477,13519,05170012,11.3,8.2,3.2,2.8,6.8,2594,1834,760,3060,2206,854,9.6,"8.3,9.6,9.9,10.2,10.5,10.9,11.1,11.0,11.2,11.6,12.0,11.9,11.3","6.9,7.6,7.6,7.9,8.0,8.1,8.2,8.1,8.1,8.4,8.8,8.7,8.2","1.4,2.0,2.3,2.4,2.5,2.7,2.9,3.0,3.1,3.1,3.2,3.1,3.2","hamminkeln, stadt"
05170016,13771,6767,7004,05170016,9.3,6.8,2.5,2.4,6.7,1253,916,337,1275,934,341,9.1,"7.3,8.0,8.1,8.7,9.0,9.4,9.1,9.4,9.7,9.7,9.7,9.6,9.3","6.2,6.5,6.3,6.8,6.7,7.0,6.8,6.9,7.0,7.1,7.1,7.0,6.8","1.1,1.5,1.8,1.9,2.2,2.4,2.3,2.5,2.7,2.6,2.7,2.5,2.5",hünxe
05170020,37683,18588,19095,05170020,10.5,8.2,2.3,2.8,8.2,4131,3085,1046,3965,3084,881,11.0,"7.8,8.9,8.9,9.2,9.5,9.8,10.0,10.3,10.4,10.7,10.7,10.8,10.5","6.6,7.3,7.1,7.3,7.4,7.7,7.8,8.0,8.1,8.1,8.4,8.5,8.2","1.1,1.6,1.7,1.9,2.1,2.1,2.2,2.2,2.3,2.6,2.2,2.3,2.3","kamp-lintfort, stadt"
05170024,104529,50973,53556,05170024,9.1,6.8,2.3,2.3,7.2,9964,7550,2414,9546,7138,2408,9.5,"6.6,7.8,8.0,8.3,8.5,8.6,8.9,9.2,9.2,9.4,9.5,9.6,9.1","5.6,6.2,6.3,6.5,6.6,6.5,6.7,6.9,6.8,6.9,7.3,7.2,6.8","1.0,1.6,1.7,1.8,1.9,2.1,2.2,2.3,2.4,2.5,2.2,2.3,2.3","moers, stadt"
05170028,27178,13184,13994,05170028,9.6,7.2,2.4,2.5,6.8,2509,1838,671,2614,1968,646,9.2,"7.0,8.3,8.3,8.6,8.9,9.1,9.6,9.6,9.6,9.9,10.0,10.0,9.6","5.9,6.5,6.4,6.5,6.8,6.9,7.2,7.0,6.8,7.1,7.5,7.5,7.2","1.1,1.8,1.9,2.1,2.2,2.2,2.4,2.6,2.7,2.8,2.5,2.5,2.4","neukirchen-vluyn, stadt"
05170032,31023,15140,15883,05170032,9.5,6.9,2.6,1.8,5.3,2203,1634,569,2950,2142,808,7.1,"6.9,8.2,8.4,8.8,9.0,9.3,9.5,9.6,9.5,9.8,9.5,9.8,9.5","5.7,6.5,6.5,6.7,6.8,6.7,6.9,6.9,6.9,7.0,7.0,7.2,6.9","1.2,1.7,2.0,2.1,2.2,2.6,2.6,2.6,2.6,2.8,2.4,2.6,2.6","rheinberg, stadt"
05170036,13635,6750,6885,05170036,11.0,7.9,3.1,3.3,8.0,1542,1094,448,1498,1080,418,11.3,"8.0,9.4,9.5,9.9,10.2,10.7,10.8,10.9,11.0,11.2,11.1,11.1,11.0","6.9,7.6,7.6,7.8,8.1,8.5,8.2,8.1,8.0,8.1,8.2,8.1,7.9","1.1,1.8,1.9,2.1,2.1,2.3,2.6,2.8,3.0,3.2,2.8,3.1,3.1",schermbeck
05170040,8819,4363,4456,05170040,11.3,7.8,3.5,4.7,11.3,1409,994,415,997,691,306,16.0,"8.7,9.9,9.8,10.0,10.3,10.8,11.4,11.2,11.4,11.3,10.8,11.5,11.3","7.3,7.9,7.6,7.4,7.6,8.0,8.3,8.0,8.0,8.0,7.8,8.1,7.8","1.4,2.1,2.2,2.6,2.7,2.8,3.1,3.2,3.4,3.3,3.0,3.4,3.5",sonsbeck
05170044,36675,18073,18602,05170044,9.5,7.2,2.3,1.6,4.9,2362,1789,573,3478,2625,853,6.4,"7.5,8.7,8.9,9.2,9.5,10.0,10.2,10.1,10.2,10.2,9.9,10.0,9.5","6.2,6.9,7.1,7.2,7.4,7.6,7.7,7.5,7.5,7.4,7.6,7.5,7.2","1.2,1.9,1.8,2.0,2.1,2.4,2.5,2.6,2.7,2.7,2.3,2.4,2.3","voerde (niederrhein), stadt"
05170048,60595,29522,31073,05170048,10.0,7.3,2.7,2.8,8.1,6595,4909,1686,6048,4435,1613,10.9,"7.9,9.2,9.3,9.5,9.8,10.1,10.3,10.4,10.6,10.6,10.5,10.5,10.0","6.6,7.3,7.3,7.4,7.6,7.6,7.6,7.6,7.6,7.6,7.9,7.8,7.3","1.3,1.9,2.0,2.1,2.3,2.5,2.6,2.8,3.0,2.9,2.7,2.7,2.7","wesel, stadt"
05170052,21510,10549,10961,05170052,10.9,7.9,3.0,2.5,7.1,2055,1528,527,2339,1695,644,9.6,"8.2,9.7,9.7,10.0,10.5,10.8,11.0,11.1,11.1,10.9,10.9,10.8,10.9","6.9,7.8,7.7,7.8,7.8,8.1,8.1,8.1,8.1,7.9,8.2,7.9,7.9","1.2,1.9,2.0,2.1,2.6,2.7,2.9,3.0,2.9,3.0,2.8,2.9,3.0","xanten, stadt"
05314000,318809,151954,166855,05314000,9.2,6.3,3.0,3.7,8.1,37808,25881,11927,29483,19926,9557,11.9,"6.4,7.8,7.9,8.2,8.4,8.6,8.9,8.8,8.9,9.6,9.3,9.4,9.2","4.8,5.5,5.5,5.6,5.6,5.7,5.8,5.7,5.7,6.1,6.4,6.4,6.3","1.6,2.3,2.4,2.6,2.7,2.9,3.0,3.1,3.2,3.4,2.9,3.0,3.0","bonn, stadt"
05315000,1060582,516976,543606,05315000,9.3,6.2,3.1,3.5,7.1,112571,75417,37154,98699,66046,32653,10.6,"6.6,8.1,8.2,8.6,8.8,9.1,9.3,9.4,9.6,9.6,9.4,9.5,9.3","5.1,5.9,5.8,6.0,6.1,6.1,6.2,6.2,6.2,6.2,6.4,6.4,6.2","1.5,2.3,2.4,2.6,2.7,3.0,3.1,3.2,3.3,3.4,2.9,3.0,3.1","köln, stadt"
05316000,163487,79590,83897,05316000,8.6,6.0,2.7,2.4,5.4,12744,8877,3867,14107,9741,4366,7.8,"6.6,7.8,8.0,8.2,8.5,8.6,8.9,9.0,9.1,9.1,8.8,8.8,8.6","5.3,5.8,5.8,6.0,6.1,6.0,6.2,6.2,6.2,6.1,6.1,6.1,6.0","1.3,2.0,2.1,2.2,2.4,2.6,2.7,2.8,2.9,3.0,2.6,2.7,2.7","leverkusen, stadt"
05334002,245885,127613,118272,05334002,11.4,8.7,2.7,3.6,10.6,34989,26111,8878,28020,21347,6673,14.2,"*,*,*,*,*,*,*,10.5,10.8,11.8,11.6,11.7,11.4","*,*,*,*,*,*,*,7.6,7.7,8.4,8.9,9.0,8.7","*,*,*,*,*,*,*,2.9,3.1,3.4,2.7,2.8,2.7","aachen, stadt"
05334004,46880,23281,23599,05334004,10.3,7.4,2.9,2.0,5.3,3440,2488,952,4831,3460,1371,7.3,"*,*,*,*,*,*,*,11.2,11.2,10.9,10.9,10.7,10.3","*,*,*,*,*,*,*,8.3,8.1,7.8,7.9,7.8,7.4","*,*,*,*,*,*,*,2.9,3.1,3.1,2.9,2.9,2.9","alsdorf, stadt"
05334008,26819,13120,13699,05334008,10.5,7.4,3.1,2.2,5.8,2162,1566,596,2807,1985,822,8.1,"*,*,*,*,*,*,*,10.2,10.5,10.9,11.1,10.9,10.5","*,*,*,*,*,*,*,7.5,7.6,7.7,8.1,7.9,7.4","*,*,*,*,*,*,*,2.7,2.9,3.1,2.9,3.1,3.1","baesweiler, stadt"
05334012,55909,27322,28587,05334012,10.1,7.3,2.8,2.6,6.7,5155,3727,1428,5674,4102,1572,9.2,"*,*,*,*,*,*,*,10.4,10.5,10.5,10.2,10.4,10.1","*,*,*,*,*,*,*,7.7,7.5,7.5,7.6,7.6,7.3","*,*,*,*,*,*,*,2.8,3.0,3.0,2.6,2.8,2.8","eschweiler, stadt"
05334016,46583,22665,23918,05334016,9.5,6.7,2.8,1.8,4.7,3029,2190,839,4447,3123,1324,6.5,"*,*,*,*,*,*,*,10.3,10.1,9.9,9.7,10.1,9.5","*,*,*,*,*,*,*,7.3,7.1,6.9,7.0,7.1,6.7","*,*,*,*,*,*,*,3.0,3.0,3.0,2.8,3.0,2.8","herzogenrath, stadt"
05334020,12352,6234,6118,05334020,13.1,8.7,4.4,5.1,11.9,2098,1474,624,1613,1071,542,17.0,"*,*,*,*,*,*,*,13.2,13.3,13.9,13.7,14.1,13.1","*,*,*,*,*,*,*,9.1,9.1,9.3,9.7,9.8,8.7","*,*,*,*,*,*,*,4.2,4.2,4.6,4.0,4.3,4.4","monschau, stadt"
05334024,8527,4214,4313,05334024,9.4,6.5,2.9,2.5,5.6,691,475,216,804,554,250,8.1,"*,*,*,*,*,*,*,9.6,9.6,9.3,9.4,9.2,9.4","*,*,*,*,*,*,*,6.9,6.8,6.5,7.0,6.5,6.5","*,*,*,*,*,*,*,2.7,2.8,2.8,2.5,2.7,2.9","roetgen, tor zur eifel"
05334028,15266,7583,7683,05334028,13.2,8.7,4.4,3.7,7.3,1677,1114,563,2008,1332,676,11.0,"*,*,*,*,*,*,*,13.5,13.2,13.5,13.5,13.8,13.2","*,*,*,*,*,*,*,9.5,9.1,9.1,9.2,9.2,8.7","*,*,*,*,*,*,*,3.9,4.0,4.4,4.3,4.6,4.4",simmerath
05334032,56739,28112,28627,05334032,10.3,7.2,3.1,2.5,5.8,4677,3281,1396,5872,4098,1774,8.2,"*,*,*,*,*,*,*,10.6,10.6,10.9,10.7,10.7,10.3","*,*,*,*,*,*,*,7.5,7.3,7.5,7.7,7.7,7.2","*,*,*,*,*,*,*,3.1,3.2,3.4,3.1,3.1,3.1","stolberg (rhld.), kupferstadt"
05334036,38962,19116,19846,05334036,9.4,6.5,3.0,3.0,6.4,3646,2476,1170,3679,2515,1164,9.4,"*,*,*,*,*,*,*,10.0,10.2,9.9,9.8,9.8,9.4","*,*,*,*,*,*,*,7.0,6.9,6.6,6.7,6.8,6.5","*,*,*,*,*,*,*,3.0,3.3,3.3,3.1,3.1,3.0","würselen, stadt"
05358004,13932,6995,6937,05358004,10.8,7.9,2.9,2.2,5.7,1097,794,303,1509,1101,408,7.9,"8.0,9.4,9.7,10.7,10.8,10.9,11.0,11.1,11.4,11.2,11.1,11.2,10.8","6.8,7.4,7.4,8.2,8.0,8.0,8.0,8.0,8.2,8.1,8.0,8.1,7.9","1.2,2.0,2.3,2.5,2.7,2.9,3.0,3.1,3.2,3.1,3.1,3.1,2.9",aldenhoven
05358008,90244,44599,45645,05358008,10.1,7.3,2.8,3.9,10.0,12583,9042,3541,9134,6590,2544,13.9,"7.2,8.5,8.7,9.3,9.4,9.6,9.7,9.9,10.0,10.4,10.4,10.4,10.1","5.8,6.6,6.6,7.0,6.9,6.9,7.1,7.1,7.2,7.4,7.7,7.5,7.3","1.3,1.9,2.2,2.3,2.4,2.6,2.6,2.7,2.8,3.0,2.7,2.9,2.8","düren, stadt"
05358012,4366,2203,2163,05358012,11.9,8.7,3.2,3.2,7.6,473,332,141,518,379,139,10.8,"9.2,10.0,9.9,10.8,10.5,11.4,11.5,11.2,11.9,11.7,11.5,12.1,11.9","7.4,7.9,7.8,8.3,8.2,8.6,8.4,8.2,8.3,8.1,8.7,8.9,8.7","1.9,2.1,2.0,2.6,2.3,2.8,3.1,3.0,3.5,3.6,2.8,3.2,3.2","heimbach, stadt"
05358016,8780,4426,4354,05358016,10.3,6.8,3.4,2.3,4.3,577,378,199,902,600,302,6.6,"6.5,8.0,7.8,8.7,9.3,9.4,10.0,10.0,10.0,10.8,10.9,10.8,10.3","5.4,6.0,5.9,6.4,6.8,6.6,6.9,7.1,6.7,7.1,7.5,7.1,6.8","1.1,2.0,2.0,2.3,2.6,2.8,3.0,2.8,3.3,3.7,3.4,3.7,3.4",hürtgenwald
05358020,7272,3579,3693,05358020,9.5,6.4,3.2,1.9,4.9,496,356,140,694,463,231,6.8,"7.6,9.1,9.3,9.5,9.6,10.3,11.0,11.2,11.2,10.4,10.5,10.6,9.5","6.1,6.9,7.0,7.3,7.1,7.4,7.9,7.8,7.7,6.9,7.2,7.0,6.4","1.4,2.2,2.3,2.3,2.5,2.9,3.2,3.4,3.4,3.5,3.2,3.5,3.2",inden
05358024,32601,16318,16283,05358024,9.8,7.1,2.7,2.7,7.3,3258,2389,869,3189,2322,867,10.0,"7.4,8.7,8.8,9.1,9.6,9.9,10.0,9.9,10.0,10.2,10.3,10.3,9.8","6.2,6.7,6.8,7.0,7.3,7.3,7.4,7.3,7.3,7.3,7.6,7.5,7.1","1.2,2.0,2.0,2.1,2.3,2.6,2.6,2.6,2.7,2.9,2.6,2.7,2.7","jülich, stadt"
05358028,17441,8579,8862,05358028,10.7,7.5,3.3,2.1,5.2,1265,903,362,1869,1300,569,7.3,"7.2,8.7,8.9,9.4,9.7,9.8,9.8,10.1,10.4,10.9,11.1,11.0,10.7","6.1,6.9,6.9,7.1,7.2,7.3,7.1,7.5,7.6,7.7,8.0,7.8,7.5","1.1,1.9,2.0,2.3,2.5,2.5,2.7,2.7,2.8,3.1,3.1,3.2,3.3",kreuzau
05358032,13791,6871,6920,05358032,10.3,7.4,2.9,1.8,5.0,937,685,252,1419,1018,401,6.8,"6.4,7.9,8.1,9.0,9.2,9.4,9.7,10.2,10.2,10.5,10.4,10.4,10.3","5.4,6.2,6.1,6.8,6.9,6.8,7.2,7.4,7.3,7.4,7.4,7.4,7.4","1.0,1.7,2.0,2.2,2.2,2.6,2.5,2.8,2.9,3.1,2.9,3.0,2.9",langerwehe
05358036,12591,6253,6338,05358036,10.5,7.5,3.0,2.1,4.6,843,577,266,1323,943,380,6.7,"7.2,8.7,8.4,8.9,9.1,9.2,9.3,9.1,9.6,10.3,10.3,10.4,10.5","6.1,6.8,6.6,6.8,6.8,6.7,6.6,6.6,6.9,7.3,7.6,7.6,7.5","1.1,1.9,1.8,2.1,2.3,2.5,2.7,2.5,2.7,3.0,2.7,2.8,3.0","linnich, stadt"
05358040,9950,4948,5002,05358040,9.9,7.0,2.9,7.7,13.7,2130,1359,771,986,693,293,21.4,"7.3,8.8,8.9,9.7,10.0,10.0,10.5,10.3,10.3,10.1,9.5,10.2,9.9","6.1,6.9,6.6,7.0,7.4,7.1,7.5,7.2,7.0,6.8,6.7,7.1,7.0","1.2,1.9,2.3,2.6,2.6,2.9,3.1,3.1,3.3,3.2,2.8,3.1,2.9",merzenich
05358044,9893,4832,5061,05358044,11.5,8.2,3.3,2.5,6.1,845,601,244,1135,808,327,8.5,"7.2,8.5,8.9,9.3,9.8,9.8,10.1,10.2,10.5,11.3,11.4,11.6,11.5","6.0,6.7,6.9,7.2,7.5,7.4,7.6,7.5,7.7,8.1,8.3,8.3,8.2","1.2,1.8,1.9,2.1,2.3,2.5,2.5,2.7,2.8,3.3,3.1,3.4,3.3","nideggen, stadt"
05358048,13915,6876,7039,05358048,10.5,7.4,3.1,2.2,5.4,1060,754,306,1466,1028,438,7.6,"7.6,9.0,9.1,9.7,10.0,10.1,10.3,10.6,10.9,10.9,10.7,10.6,10.5","6.3,7.0,7.1,7.2,7.4,7.5,7.5,7.8,7.7,7.5,7.5,7.4,7.4","1.3,2.0,2.0,2.5,2.6,2.7,2.7,2.8,3.2,3.4,3.3,3.3,3.1",niederzier
05358052,10552,5249,5303,05358052,10.5,7.2,3.3,1.5,3.9,565,407,158,1104,760,344,5.4,"7.1,8.4,8.5,9.2,9.6,9.6,9.8,9.7,9.8,10.6,10.4,10.5,10.5","6.0,6.7,6.6,6.9,7.2,6.8,6.9,7.0,6.6,7.0,7.2,7.3,7.2","1.0,1.7,1.9,2.3,2.4,2.8,2.8,2.7,3.2,3.6,3.2,3.1,3.3",nörvenich
05358056,8277,4150,4127,05358056,9.0,6.2,2.8,1.6,4.1,477,341,136,749,516,233,5.8,"7.4,8.4,8.6,9.1,9.2,9.9,10.0,9.9,9.6,9.5,9.5,9.6,9.0","6.2,6.6,6.6,6.8,6.7,7.1,7.0,7.1,6.8,6.4,6.8,6.6,6.2","1.2,1.8,2.0,2.2,2.5,2.8,2.9,2.7,2.9,3.2,2.7,3.0,2.8",titz
05358060,9223,4644,4579,05358060,10.5,7.6,3.0,1.7,3.7,492,337,155,971,698,273,5.3,"7.3,8.8,9.2,9.7,10.4,10.9,10.6,10.9,11.3,11.4,11.0,11.1,10.5","6.2,6.9,7.0,7.6,7.9,8.1,8.0,8.1,8.2,7.9,8.0,8.1,7.6","1.1,1.9,2.2,2.1,2.5,2.8,2.6,2.8,3.1,3.5,3.0,3.0,3.0",vettweiß
05362004,23334,11676,11658,05362004,9.7,6.8,2.9,2.5,5.8,1922,1348,574,2266,1590,676,8.2,"6.7,7.9,8.1,8.1,8.5,8.7,9.2,9.6,9.8,10.3,10.2,10.1,9.7","5.6,6.3,6.4,6.2,6.5,6.6,7.0,7.2,7.1,7.4,7.5,7.4,6.8","1.1,1.6,1.7,1.9,2.0,2.0,2.2,2.3,2.7,2.9,2.6,2.7,2.9","bedburg, stadt"
05362008,60390,29779,30611,05362008,9.8,6.8,3.0,2.8,6.1,5382,3701,1681,5892,4090,1802,8.9,"6.9,8.4,8.5,8.6,9.0,9.2,9.6,9.6,9.8,10.0,10.0,10.0,9.8","5.6,6.4,6.4,6.4,6.6,6.6,6.9,6.8,6.9,6.9,7.2,7.1,6.8","1.3,2.0,2.0,2.2,2.4,2.6,2.7,2.8,2.9,3.1,2.8,2.9,3.0","bergheim, stadt"
05362012,44768,21443,23325,05362012,9.0,6.1,2.9,2.8,5.6,3764,2502,1262,4048,2732,1316,8.4,"6.6,7.6,7.7,8.2,8.3,8.5,8.8,8.9,8.9,8.9,9.0,9.0,9.0","5.3,5.7,5.6,5.8,5.7,5.9,6.0,5.9,5.9,5.9,6.2,6.2,6.1","1.3,1.9,2.0,2.3,2.6,2.6,2.7,3.1,3.1,3.0,2.7,2.8,2.9","brühl, stadt"
05362016,21232,10453,10779,05362016,9.1,6.3,2.9,2.3,5.0,1551,1071,480,1942,1329,613,7.3,"6.7,7.9,7.6,8.2,8.5,8.8,9.1,9.2,9.2,9.4,9.6,9.5,9.1","5.5,6.0,5.7,6.0,6.0,6.3,6.4,6.4,6.3,6.3,6.8,6.7,6.3","1.3,1.9,2.0,2.2,2.5,2.6,2.7,2.8,2.9,3.1,2.8,2.9,2.9","elsdorf, stadt"
05362020,49786,24168,25618,05362020,8.6,6.0,2.6,2.3,5.2,3723,2602,1121,4273,2966,1307,7.5,"6.1,7.4,7.4,7.6,8.0,8.2,8.6,8.9,8.9,8.9,8.8,8.8,8.6","5.0,5.6,5.6,5.6,5.9,5.8,6.2,6.3,6.2,6.1,6.2,6.1,6.0","1.1,1.7,1.8,2.0,2.1,2.4,2.5,2.6,2.7,2.8,2.6,2.6,2.6","erftstadt, stadt"
05362024,51999,25311,26688,05362024,9.4,6.2,3.2,3.4,6.2,4984,3215,1769,4883,3207,1676,9.6,"7.2,8.5,8.6,9.0,9.2,9.4,9.9,9.8,9.7,9.9,9.7,9.6,9.4","5.7,6.3,6.2,6.4,6.3,6.4,6.6,6.5,6.4,6.5,6.5,6.5,6.2","1.5,2.2,2.4,2.6,2.9,3.0,3.2,3.3,3.3,3.4,3.1,3.1,3.2","frechen, stadt"
05362028,59496,29173,30323,05362028,9.6,6.3,3.3,3.3,6.3,5744,3764,1980,5691,3729,1962,9.7,"7.2,8.6,8.8,8.9,9.2,9.4,9.6,9.7,9.7,10.2,9.7,9.9,9.6","5.8,6.5,6.4,6.4,6.4,6.5,6.4,6.5,6.3,6.6,6.6,6.5,6.3","1.4,2.1,2.3,2.5,2.7,3.0,3.2,3.2,3.5,3.7,3.1,3.3,3.3","hürth, stadt"
05362032,65477,32337,33140,05362032,9.8,6.6,3.2,3.9,6.3,6680,4154,2526,6388,4289,2099,10.2,"7.2,8.6,8.7,9.0,9.4,9.7,9.8,9.8,10.0,10.3,10.1,10.0,9.8","5.8,6.6,6.5,6.6,6.8,6.7,6.8,6.7,6.8,6.9,7.0,6.9,6.6","1.3,2.0,2.2,2.4,2.7,3.0,3.0,3.0,3.2,3.4,3.1,3.1,3.2","kerpen, kolpingstadt"
05362036,54200,26267,27933,05362036,8.4,5.6,2.8,3.5,6.7,5525,3643,1882,4563,3058,1505,10.2,"6.3,7.3,7.6,7.8,7.9,8.1,8.5,8.6,8.5,8.7,8.5,8.7,8.4","5.1,5.6,5.6,5.7,5.7,5.7,5.9,6.0,5.8,6.0,5.9,6.0,5.6","1.2,1.7,2.0,2.2,2.2,2.4,2.6,2.6,2.7,2.8,2.7,2.7,2.8","pulheim, stadt"
05362040,35975,17843,18132,05362040,9.9,6.7,3.1,2.6,5.2,2797,1856,941,3544,2428,1116,7.8,"7.3,8.5,8.6,9.4,10.0,10.2,10.5,10.4,10.5,10.5,10.2,10.1,9.9","5.8,6.2,6.3,6.6,6.9,7.0,7.0,7.0,6.9,7.0,7.0,7.0,6.7","1.5,2.3,2.4,2.8,3.1,3.3,3.4,3.4,3.6,3.5,3.2,3.1,3.1","wesseling, stadt"
05366004,17367,8536,8831,05366004,10.5,7.2,3.3,2.6,5.8,1447,1000,447,1825,1248,577,8.3,"6.8,8.0,8.7,8.9,9.1,9.4,9.6,10.0,10.1,10.3,10.4,10.8,10.5","5.7,6.3,6.7,6.9,6.8,6.9,6.8,7.0,7.0,7.1,7.3,7.4,7.2","1.1,1.7,2.0,2.1,2.3,2.6,2.8,3.0,3.0,3.2,3.1,3.4,3.3","bad münstereifel, stadt"
05366008,8471,4343,4128,05366008,10.1,6.9,3.2,3.0,5.8,752,494,258,856,587,269,8.9,"7.5,8.7,9.0,9.2,9.5,9.9,10.0,10.0,10.2,10.0,10.2,10.1,10.1","6.3,6.9,7.0,7.0,7.3,7.4,7.4,7.0,7.1,7.0,7.1,6.9,6.9","1.2,1.8,2.0,2.2,2.2,2.5,2.6,3.0,3.0,3.0,3.1,3.1,3.2",blankenheim
05366012,4236,2085,2151,05366012,11.9,8.4,3.5,1.9,5.4,311,229,82,502,354,148,7.3,"8.5,9.3,9.3,10.0,10.5,10.2,11.0,11.4,11.7,11.2,11.7,11.9,11.9","6.7,7.4,7.3,8.1,8.1,7.8,8.1,8.3,8.5,7.7,8.4,8.4,8.4","1.8,1.9,2.0,1.9,2.4,2.5,2.9,3.1,3.2,3.5,3.4,3.5,3.5",dahlem
05366016,56769,27854,28915,05366016,9.8,6.7,3.1,3.0,6.7,5497,3783,1714,5587,3803,1784,9.7,"7.4,8.6,8.9,9.5,9.8,10.0,10.0,10.1,10.2,10.0,9.9,10.1,9.8","6.0,6.5,6.6,6.9,7.0,7.1,6.9,6.9,7.0,6.7,6.9,6.9,6.7","1.4,2.1,2.2,2.5,2.7,2.9,3.1,3.2,3.2,3.3,3.0,3.2,3.1","euskirchen, stadt"
05366020,8094,4125,3969,05366020,11.5,7.6,3.9,2.4,4.5,565,367,198,929,615,314,7.0,"8.0,9.5,9.9,10.2,10.8,11.0,11.0,11.5,11.9,12.0,11.9,11.8,11.5","6.4,6.9,7.3,7.4,8.1,7.9,7.8,8.1,8.3,7.9,8.2,7.7,7.6","1.6,2.5,2.5,2.9,2.7,3.1,3.3,3.4,3.6,4.2,3.7,4.0,3.9",hellenthal
05366024,11229,5606,5623,05366024,10.8,7.3,3.5,6.1,9.7,1768,1085,683,1216,822,394,15.7,"7.6,9.0,9.0,9.4,9.7,10.0,10.0,10.0,10.4,10.8,11.1,11.1,10.8","6.3,7.1,7.1,7.3,7.4,7.3,7.3,7.3,7.2,7.5,7.9,7.6,7.3","1.3,1.9,2.0,2.1,2.4,2.7,2.7,2.8,3.1,3.2,3.2,3.5,3.5",kall
05366028,27170,13551,13619,05366028,10.0,6.9,3.1,2.7,5.5,2205,1482,723,2729,1880,849,8.1,"7.6,8.6,8.7,9.1,9.3,9.6,9.7,10.0,10.3,10.6,10.3,10.3,10.0","6.1,6.5,6.6,6.8,6.8,7.0,7.0,7.1,7.1,7.3,7.4,7.3,6.9","1.5,2.1,2.2,2.3,2.5,2.6,2.7,2.9,3.2,3.3,2.9,3.0,3.1","mechernich, stadt"
05366032,7469,3713,3756,05366032,11.2,7.2,4.0,2.8,5.2,598,392,206,839,541,298,8.0,"7.6,8.9,8.8,8.9,9.2,10.3,9.9,10.2,10.4,10.7,11.2,11.1,11.2","6.2,6.9,6.8,6.7,6.9,7.4,6.9,7.0,7.1,7.3,7.5,7.5,7.2","1.4,2.0,2.1,2.2,2.3,2.9,3.0,3.2,3.4,3.4,3.6,3.6,4.0",nettersheim
05366036,13272,6623,6649,05366036,11.4,7.7,3.7,3.5,7.7,1496,1028,468,1513,1021,492,11.3,"8.5,10.0,10.2,10.9,11.0,11.1,11.5,12.0,11.9,12.3,11.8,12.1,11.4","6.8,7.5,7.7,8.1,7.8,7.8,8.0,8.6,8.4,8.3,8.2,8.3,7.7","1.7,2.4,2.5,2.8,3.2,3.3,3.4,3.4,3.6,4.1,3.7,3.7,3.7","schleiden, stadt"
05366040,16997,8404,8593,05366040,9.2,6.0,3.2,1.9,4.0,998,683,315,1571,1027,544,5.9,"6.4,7.7,7.7,8.3,8.5,8.8,9.2,9.2,9.1,9.3,9.2,9.5,9.2","5.3,6.0,5.7,6.0,6.0,6.1,6.2,6.2,6.0,6.2,6.1,6.4,6.0","1.1,1.8,2.1,2.3,2.6,2.8,3.0,3.0,3.1,3.1,3.0,3.1,3.2",weilerswist
05366044,20091,9919,10172,05366044,10.3,7.0,3.3,3.1,6.1,1853,1231,622,2079,1415,664,9.2,"7.7,8.7,9.1,9.6,9.6,10.2,10.2,10.1,10.3,10.5,10.5,10.9,10.3","6.3,6.7,6.8,7.1,7.1,7.3,7.3,7.1,7.2,7.0,7.3,7.5,7.0","1.3,2.0,2.2,2.4,2.5,2.9,2.9,3.0,3.1,3.4,3.2,3.4,3.3","zülpich, stadt"
05370004,43350,21170,22180,05370004,10.1,7.1,3.1,3.0,7.7,4665,3352,1313,4386,3058,1328,10.8,"8.2,9.3,9.2,9.5,9.8,9.9,9.9,10.1,10.3,10.6,10.6,10.6,10.1","6.9,7.4,7.3,7.4,7.5,7.4,7.3,7.4,7.4,7.4,7.7,7.6,7.1","1.3,1.9,2.0,2.1,2.3,2.5,2.7,2.7,2.9,3.1,2.9,3.1,3.1","erkelenz, stadt"
05370008,12015,6002,6013,05370008,9.9,7.0,2.8,2.5,7.4,1190,885,305,1187,847,340,9.9,"7.9,9.0,9.2,9.4,9.6,10.0,10.1,10.6,10.5,10.1,10.2,10.3,9.9","6.8,7.5,7.5,7.8,7.6,7.7,7.8,7.9,7.8,7.5,7.7,7.6,7.0","1.1,1.5,1.6,1.6,2.1,2.3,2.3,2.7,2.7,2.6,2.5,2.7,2.8",gangelt
05370012,26963,13424,13539,05370012,11.1,7.9,3.2,3.1,7.8,2941,2096,845,3006,2135,871,10.9,"8.0,9.1,8.9,9.2,9.7,9.9,10.2,10.0,10.5,11.2,11.2,11.2,11.1","6.9,7.4,7.1,7.3,7.4,7.4,7.6,7.2,7.5,7.8,8.0,7.9,7.9","1.1,1.8,1.8,2.0,2.3,2.6,2.6,2.9,3.0,3.3,3.2,3.3,3.2","geilenkirchen, stadt"
05370016,41538,20387,21151,05370016,10.4,7.6,2.9,3.4,9.6,5378,3980,1398,4323,3139,1184,12.9,"9.3,10.6,10.6,10.7,10.7,10.8,11.0,11.2,11.1,10.9,10.8,10.7,10.4","8.1,8.9,8.7,8.7,8.5,8.5,8.4,8.5,8.3,8.1,8.2,8.0,7.6","1.3,1.7,1.8,2.0,2.2,2.3,2.6,2.7,2.8,2.8,2.6,2.7,2.9","heinsberg, stadt"
05370020,39531,19537,19994,05370020,10.0,7.3,2.7,2.0,5.9,3134,2324,810,3967,2903,1064,7.9,"8.1,9.5,9.6,10.0,10.3,10.6,10.4,10.6,10.7,10.7,10.7,10.6,10.0","7.1,7.9,7.9,7.9,8.1,8.2,8.0,8.0,8.0,7.8,8.0,7.8,7.3","1.1,1.7,1.8,2.1,2.1,2.4,2.4,2.6,2.7,2.9,2.7,2.7,2.7","hückelhoven, stadt"
05370024,10167,5173,4994,05370024,7.8,6.1,1.7,1.5,5.7,730,577,153,794,623,171,7.2,"6.0,7.1,7.1,7.4,7.7,7.9,8.2,8.3,8.4,8.1,8.0,7.9,7.8","5.1,6.0,5.8,6.2,6.2,6.4,6.5,6.6,6.6,6.4,6.4,6.2,6.1","0.9,1.1,1.3,1.2,1.4,1.5,1.7,1.6,1.9,1.7,1.6,1.7,1.7",selfkant
05370028,24377,12270,12107,05370028,10.6,7.9,2.7,2.3,6.8,2215,1650,565,2594,1932,662,9.1,"9.0,10.2,10.1,10.7,10.8,11.3,11.4,11.0,11.1,11.2,11.6,11.5,10.6","7.8,8.3,8.2,8.6,8.5,9.0,8.9,8.2,8.2,8.4,8.8,8.7,7.9","1.2,1.8,1.9,2.1,2.2,2.3,2.5,2.8,2.9,2.8,2.8,2.7,2.7","übach-palenberg, stadt"
05370032,8861,4447,4414,05370032,9.9,7.5,2.4,1.8,6.2,709,553,156,876,665,211,8.0,"7.8,8.4,8.8,8.9,9.1,9.7,9.7,10.2,10.5,10.7,10.3,10.3,9.9","6.8,7.0,7.2,7.2,7.3,7.4,7.4,7.8,7.9,7.9,7.9,8.0,7.5","1.0,1.4,1.6,1.7,1.8,2.2,2.2,2.4,2.6,2.7,2.3,2.3,2.4",waldfeucht
05370036,17898,8889,9009,05370036,9.7,6.9,2.8,2.1,5.4,1347,975,372,1734,1233,501,7.5,"8.5,9.3,9.6,9.9,9.9,10.0,9.9,10.2,10.3,10.5,10.3,10.3,9.7","7.5,7.8,7.9,8.0,7.9,7.5,7.5,7.7,7.6,7.5,7.5,7.4,6.9","1.0,1.5,1.7,1.9,2.0,2.5,2.3,2.5,2.7,2.9,2.8,2.9,2.8","wassenberg, stadt"
05370040,27827,13657,14170,05370040,10.1,7.1,3.1,2.6,6.1,2412,1695,717,2816,1962,854,8.7,"7.5,8.8,8.8,9.1,9.3,9.6,10.0,10.3,10.3,10.5,10.5,10.6,10.1","6.2,7.0,6.8,7.0,7.0,7.1,7.3,7.5,7.3,7.4,7.5,7.6,7.1","1.3,1.8,2.0,2.2,2.3,2.5,2.7,2.8,2.9,3.0,3.0,3.1,3.1","wegberg, stadt"
05374004,18940,9294,9646,05374004,10.1,7.2,2.9,2.0,4.9,1315,937,378,1911,1365,546,6.9,"7.0,8.1,8.3,8.8,9.0,9.5,9.1,9.2,9.5,10.0,10.0,10.0,10.1","5.7,6.0,6.1,6.3,6.6,6.6,6.5,6.7,6.7,7.0,7.2,7.2,7.2","1.4,2.0,2.2,2.5,2.5,2.9,2.6,2.5,2.8,3.0,2.7,2.9,2.9","bergneustadt, stadt"
05374008,19307,9395,9912,05374008,10.6,6.7,3.8,3.6,6.3,1902,1215,687,2043,1300,743,9.9,"7.8,9.3,9.2,9.5,9.7,10.1,10.0,10.2,10.6,10.7,10.7,10.6,10.6","6.2,7.0,6.6,6.8,6.8,6.8,6.7,6.8,7.0,6.8,7.2,7.0,6.7","1.6,2.4,2.5,2.7,2.9,3.3,3.2,3.4,3.6,3.9,3.5,3.6,3.8",engelskirchen
05374012,50412,24870,25542,05374012,10.9,7.2,3.6,3.9,8.0,5957,4008,1949,5477,3648,1829,11.8,"7.9,8.9,9.0,9.4,9.7,10.1,10.0,10.3,10.3,10.5,10.8,10.9,10.9","6.2,6.6,6.4,6.7,6.8,6.9,7.0,7.0,6.8,6.8,7.4,7.5,7.2","1.7,2.4,2.6,2.7,2.9,3.1,3.0,3.3,3.4,3.7,3.4,3.5,3.6","gummersbach, stadt"
05374016,15275,7620,7655,05374016,10.7,7.2,3.5,3.0,5.9,1354,901,453,1629,1099,530,8.9,"8.5,9.7,10.1,10.3,10.6,10.9,10.6,10.6,10.6,11.0,11.1,11.0,10.7","6.7,7.2,7.4,7.3,7.4,7.7,7.5,7.5,7.2,7.6,7.7,7.6,7.2","1.8,2.4,2.7,3.0,3.2,3.2,3.1,3.2,3.4,3.4,3.4,3.4,3.5","hückeswagen, schloss-stadt"
05374020,21382,10491,10891,05374020,11.9,7.9,3.9,3.4,6.9,2188,1469,719,2536,1695,841,10.2,"8.3,9.5,10.1,10.4,10.9,11.4,11.3,11.7,11.8,12.3,12.1,12.0,11.9","6.8,7.3,7.6,7.6,7.8,7.9,7.8,8.1,8.1,8.3,8.4,8.1,7.9","1.5,2.2,2.5,2.8,3.0,3.5,3.5,3.6,3.7,4.0,3.7,3.9,3.9",lindlar
05374024,13560,6750,6810,05374024,10.5,6.8,3.7,2.7,4.8,1017,647,370,1423,924,499,7.5,"7.6,9.2,9.3,9.4,9.9,10.1,9.3,10.0,10.3,10.4,10.6,10.7,10.5","6.2,6.9,6.8,6.6,7.0,6.8,6.5,6.7,6.7,6.8,7.1,7.0,6.8","1.4,2.3,2.5,2.7,2.9,3.3,2.8,3.3,3.6,3.6,3.6,3.7,3.7",marienheide
05374028,10402,5228,5174,05374028,11.7,8.1,3.6,3.4,6.2,998,649,349,1214,844,370,9.6,"8.5,9.7,9.2,9.7,10.5,10.3,10.5,10.4,11.1,11.5,11.5,11.3,11.7","7.1,7.5,7.1,7.2,7.9,7.3,7.7,7.8,7.9,7.9,8.2,7.7,8.1","1.5,2.2,2.1,2.4,2.6,3.0,2.8,2.7,3.1,3.5,3.3,3.6,3.6",morsbach
05374032,17002,8310,8692,05374032,9.9,6.5,3.4,2.7,5.1,1335,871,464,1690,1104,586,7.9,"7.8,8.7,8.7,8.9,9.4,9.7,9.7,10.0,10.0,10.0,10.3,10.4,9.9","6.5,6.6,6.6,6.5,6.7,6.7,6.7,7.0,6.7,6.5,7.0,7.0,6.5","1.3,2.1,2.1,2.4,2.7,3.0,3.0,3.0,3.3,3.4,3.3,3.4,3.4",nümbrecht
05374036,22386,10916,11470,05374036,10.7,7.1,3.6,3.7,6.6,2310,1488,822,2397,1587,810,10.3,"8.7,10.3,10.3,10.6,11.2,11.3,10.7,11.3,11.6,11.2,10.9,10.9,10.7","6.5,7.3,7.2,7.6,7.7,7.5,7.3,7.5,7.5,7.2,7.3,7.2,7.1","2.2,3.0,3.1,3.1,3.5,3.8,3.4,3.8,4.1,4.0,3.7,3.7,3.6","radevormwald, stadt auf der höhe"
05374040,18837,9499,9338,05374040,10.5,7.0,3.5,4.7,8.1,2413,1531,882,1971,1319,652,12.8,"7.9,8.9,9.0,9.1,9.3,9.8,9.7,9.7,10.0,10.5,10.7,10.8,10.5","6.4,6.8,6.7,6.7,6.7,6.9,6.8,6.7,6.8,7.1,7.6,7.4,7.0","1.5,2.1,2.3,2.4,2.7,3.0,2.9,2.9,3.2,3.4,3.1,3.4,3.5",reichshof
05374044,19194,9389,9805,05374044,10.1,6.6,3.5,2.8,6.2,1738,1191,547,1941,1275,666,9.1,"8.4,9.4,8.8,9.1,9.2,9.2,9.2,9.2,9.8,9.9,10.1,10.6,10.1","6.9,6.9,6.4,6.5,6.4,6.6,6.5,6.6,6.4,6.6,7.0,7.2,6.6","1.5,2.5,2.4,2.5,2.8,2.6,2.7,2.7,3.4,3.3,3.1,3.4,3.5","waldbröl, stadt"
05374048,25274,12253,13021,05374048,10.5,6.9,3.6,5.1,9.3,3628,2346,1282,2653,1734,919,14.4,"8.1,9.0,9.0,9.2,9.5,10.1,9.7,9.7,10.1,10.2,10.5,10.5,10.5","6.4,6.9,6.6,6.6,6.8,6.9,6.6,6.6,6.7,6.7,7.0,7.0,6.9","1.7,2.2,2.3,2.7,2.8,3.2,3.0,3.1,3.4,3.6,3.5,3.5,3.6","wiehl, stadt"
05374052,21481,10655,10826,05374052,12.7,8.3,4.3,3.9,7.7,2490,1646,844,2721,1791,930,11.6,"9.4,10.9,11.1,11.3,11.6,12.1,11.5,11.5,11.9,12.9,12.8,12.7,12.7","7.4,8.1,8.2,7.9,8.1,8.4,8.0,8.0,8.0,8.5,8.6,8.4,8.3","2.0,2.9,2.9,3.3,3.5,3.7,3.5,3.5,3.8,4.5,4.2,4.2,4.3","wipperfürth, hansestadt"
05378004,111366,53479,57887,05378004,9.3,6.2,3.0,3.2,6.5,10797,7252,3545,10327,6960,3367,9.7,"6.9,8.2,8.4,8.8,9.1,9.3,9.8,9.7,9.9,9.7,9.6,9.5,9.3","5.5,6.1,6.1,6.3,6.4,6.5,6.8,6.6,6.7,6.5,6.7,6.5,6.2","1.4,2.1,2.3,2.5,2.6,2.8,3.0,3.0,3.2,3.2,2.9,3.0,3.0","bergisch gladbach, stadt"
05378008,18256,9037,9219,05378008,10.0,6.8,3.2,2.7,6.0,1594,1099,495,1826,1241,585,8.7,"6.9,8.2,8.1,8.6,9.1,9.2,9.5,9.9,10.1,10.3,10.1,10.1,10.0","5.5,5.9,5.7,6.1,6.5,6.3,6.7,6.9,6.9,6.9,7.0,7.0,6.8","1.5,2.3,2.3,2.5,2.6,2.9,2.8,3.0,3.2,3.4,3.0,3.1,3.2","burscheid, stadt"
05378012,19893,9823,10070,05378012,11.1,7.6,3.6,3.9,6.5,2083,1299,784,2213,1505,708,10.5,"9.0,10.3,10.6,11.0,11.0,11.4,11.4,11.2,11.6,11.9,11.7,11.7,11.1","7.2,7.8,7.9,7.9,7.9,7.9,8.0,7.8,7.9,8.1,8.1,8.0,7.6","1.8,2.6,2.7,3.1,3.1,3.5,3.4,3.4,3.7,3.8,3.6,3.7,3.6",kürten
05378016,27937,13468,14469,05378016,8.5,5.9,2.6,2.5,5.4,2223,1521,702,2378,1662,716,8.0,"6.4,7.3,7.5,8.1,8.3,8.5,8.3,8.5,8.8,8.7,8.6,8.9,8.5","5.3,5.6,5.6,6.0,6.0,6.0,5.9,6.1,6.2,6.0,6.2,6.3,5.9","1.1,1.6,1.9,2.1,2.3,2.5,2.4,2.4,2.7,2.7,2.5,2.6,2.6","leichlingen (rheinland), blütenstadt"
05378020,15123,7456,7667,05378020,8.8,5.8,3.0,2.0,3.7,867,561,306,1332,875,457,5.7,"6.2,7.3,7.1,7.4,8.0,8.4,8.5,8.6,8.8,9.4,9.4,9.3,8.8","5.2,5.6,5.4,5.5,5.8,5.9,5.9,5.9,6.0,6.5,6.5,6.2,5.8","1.0,1.7,1.7,1.9,2.2,2.5,2.6,2.7,2.8,2.9,2.9,3.1,3.0",odenthal
05378024,27264,13439,13825,05378024,10.5,7.0,3.5,3.2,6.3,2574,1711,863,2870,1911,959,9.4,"7.6,9.4,9.5,9.9,10.2,10.6,10.5,10.5,10.7,10.8,10.5,10.7,10.5","6.0,6.9,6.9,7.1,7.3,7.5,7.2,7.2,7.2,7.2,7.1,7.2,7.0","1.6,2.5,2.5,2.8,2.9,3.2,3.3,3.3,3.5,3.6,3.4,3.5,3.5","overath, stadt"
05378028,28386,13934,14452,05378028,9.2,6.1,3.1,2.4,5.2,2178,1485,693,2624,1735,889,7.7,"6.4,7.8,7.8,8.1,8.4,8.9,9.0,9.0,9.3,9.3,9.2,9.5,9.2","5.1,5.7,5.6,5.8,5.9,6.1,6.1,6.0,6.1,6.1,6.3,6.3,6.1","1.4,2.0,2.2,2.3,2.4,2.8,2.9,3.0,3.2,3.2,2.9,3.2,3.1","rösrath, stadt"
05378032,34504,16802,17702,05378032,10.5,7.0,3.5,3.6,7.0,3666,2422,1244,3619,2403,1216,10.6,"8.1,9.5,9.5,9.8,10.2,10.6,10.3,10.5,10.6,10.5,10.4,10.8,10.5","6.3,7.1,6.9,7.1,7.3,7.3,7.2,7.2,7.1,7.0,7.0,7.2,7.0","1.8,2.4,2.7,2.7,3.0,3.2,3.1,3.3,3.5,3.5,3.4,3.6,3.5","wermelskirchen, stadt"
05382004,23435,11515,11920,05382004,9.9,6.3,3.7,2.0,3.6,1296,836,460,2324,1467,857,5.5,"6.8,8.1,8.3,8.6,9.2,9.6,9.7,9.8,10.0,10.0,9.8,9.9,9.9","5.1,5.6,5.6,5.9,6.0,6.2,6.2,6.4,6.5,6.3,6.3,6.6,6.3","1.8,2.4,2.7,2.7,3.2,3.3,3.5,3.4,3.5,3.7,3.5,3.4,3.7",alfter
05382008,25654,12337,13317,05382008,9.7,6.4,3.3,4.3,8.6,3307,2216,1091,2495,1640,855,12.9,"6.8,8.0,8.3,8.6,8.8,9.6,9.6,9.6,9.8,9.7,9.8,9.8,9.7","5.2,5.7,5.9,5.9,6.0,6.5,6.3,6.3,6.4,6.4,6.6,6.4,6.4","1.6,2.3,2.4,2.7,2.8,3.1,3.3,3.3,3.3,3.3,3.2,3.4,3.3","bad honnef, stadt"
05382012,47636,23280,24356,05382012,9.6,6.1,3.4,3.1,5.8,4240,2743,1497,4553,2912,1641,8.9,"6.7,8.1,8.0,8.4,8.6,8.9,9.0,9.3,9.6,10.0,10.0,10.0,9.6","5.1,5.8,5.6,5.7,5.8,5.9,6.0,6.1,6.1,6.3,6.6,6.5,6.1","1.6,2.3,2.4,2.7,2.8,3.0,3.1,3.2,3.5,3.7,3.4,3.5,3.4","bornheim, stadt"
05382016,18864,9428,9436,05382016,9.7,6.8,2.9,2.4,5.7,1538,1082,456,1827,1285,542,8.2,"7.5,8.4,8.6,8.6,8.8,9.0,9.2,9.1,9.6,10.3,9.9,10.0,9.7","6.3,6.5,6.5,6.4,6.5,6.5,6.6,6.4,6.7,7.1,7.2,7.2,6.8","1.3,1.9,2.2,2.1,2.3,2.6,2.6,2.7,2.9,3.2,2.7,2.9,2.9",eitorf
05382020,46902,22868,24034,05382020,10.0,6.5,3.4,3.1,5.9,4184,2745,1439,4673,3072,1601,8.9,"7.2,8.7,8.6,9.0,9.3,9.7,9.7,9.8,9.9,10.2,10.3,10.2,10.0","5.8,6.6,6.3,6.6,6.6,6.7,6.7,6.6,6.7,6.7,7.0,6.9,6.5","1.4,2.1,2.3,2.5,2.7,3.0,3.0,3.2,3.3,3.5,3.3,3.3,3.4","hennef (sieg), stadt"
05382024,40702,19858,20844,05382024,9.2,6.1,3.1,2.3,4.9,2943,1990,953,3754,2487,1267,7.2,"6.8,8.3,8.4,8.6,8.9,9.1,9.4,9.4,9.4,9.5,9.4,9.4,9.2","5.4,6.1,6.1,6.2,6.3,6.3,6.5,6.4,6.2,6.3,6.4,6.4,6.1","1.4,2.2,2.3,2.4,2.6,2.8,2.9,3.0,3.2,3.3,3.0,3.0,3.1","königswinter, stadt"
05382028,30348,14915,15433,05382028,9.0,6.1,2.9,5.5,14.3,5995,4330,1665,2718,1837,881,19.8,"6.7,7.6,7.7,8.2,8.4,8.5,8.5,8.7,8.6,9.3,9.1,9.2,9.0","5.5,5.7,5.7,6.0,5.9,6.0,6.0,6.0,5.7,6.2,6.2,6.4,6.1","1.2,1.9,1.9,2.2,2.5,2.5,2.5,2.7,2.9,3.1,2.9,2.9,2.9","lohmar, stadt"
05382032,24357,11905,12452,05382032,9.2,6.3,2.9,3.6,6.6,2468,1600,868,2229,1526,703,10.1,"7.3,8.6,8.5,9.0,9.4,9.7,9.9,9.9,9.9,10.0,9.7,9.6,9.2","5.9,6.4,6.4,6.6,6.9,7.0,7.0,6.7,6.8,6.6,6.8,6.6,6.3","1.4,2.1,2.1,2.4,2.5,2.7,2.8,3.3,3.1,3.4,2.9,3.0,2.9","meckenheim, stadt"
05382036,14468,7078,7390,05382036,10.1,6.8,3.3,2.7,4.8,1086,692,394,1459,977,482,7.5,"7.0,8.3,8.3,8.6,9.0,9.3,9.5,9.6,10.0,10.4,10.5,10.5,10.1","5.9,6.4,6.2,6.5,6.6,6.6,6.8,6.6,6.8,6.8,7.2,7.2,6.8","1.2,1.9,2.0,2.1,2.4,2.7,2.8,3.0,3.2,3.6,3.3,3.4,3.3",much
05382040,19862,9811,10051,05382040,9.3,6.1,3.2,2.2,5.0,1425,984,441,1848,1217,631,7.2,"6.8,7.9,8.3,8.9,8.9,9.3,9.4,9.3,9.3,10.1,10.1,9.8,9.3","5.4,5.9,6.0,6.4,6.4,6.5,6.6,6.4,6.3,6.8,6.9,6.7,6.1","1.4,2.0,2.3,2.5,2.5,2.8,2.9,2.9,3.0,3.3,3.2,3.1,3.2",neunkirchen-seelscheid
05382044,37583,18543,19040,05382044,9.2,5.9,3.3,2.0,4.0,2234,1494,740,3447,2201,1246,5.9,"7.0,8.1,8.2,8.6,8.8,9.1,9.2,9.1,9.4,9.5,9.4,9.3,9.2","5.6,5.9,5.8,6.0,6.0,6.1,5.9,5.9,6.0,6.0,6.1,6.0,5.9","1.4,2.2,2.4,2.6,2.8,3.0,3.3,3.2,3.3,3.5,3.2,3.2,3.3","niederkassel, stadt"
05382048,27224,13508,13716,05382048,10.0,6.8,3.2,3.3,7.2,2839,1947,892,2728,1848,880,10.4,"7.3,8.4,8.6,8.7,9.2,9.5,9.7,9.8,9.9,10.3,9.9,10.1,10.0","5.8,6.4,6.4,6.4,6.5,6.7,6.9,6.8,6.7,6.9,6.8,6.9,6.8","1.5,2.0,2.2,2.3,2.7,2.8,2.8,3.0,3.2,3.4,3.1,3.2,3.2","rheinbach, stadt"
05382052,10461,5126,5335,05382052,9.3,6.5,2.8,1.7,3.7,558,382,176,971,680,291,5.3,"6.3,7.8,7.4,8.0,8.5,8.7,9.0,9.3,8.9,9.4,9.1,9.4,9.3","5.1,5.9,5.6,6.0,6.2,6.1,6.3,6.8,6.3,6.5,6.7,6.8,6.5","1.2,1.9,1.8,2.0,2.3,2.5,2.7,2.5,2.6,2.9,2.5,2.6,2.8",ruppichteroth
05382056,55709,27246,28463,05382056,8.8,5.8,3.0,2.5,4.7,3966,2593,1373,4891,3205,1686,7.1,"6.6,7.8,8.1,8.5,8.7,9.0,9.3,9.1,9.0,9.3,9.2,9.1,8.8","5.3,5.7,5.8,6.0,6.0,6.0,6.1,6.0,5.8,6.0,6.2,6.1,5.8","1.4,2.1,2.4,2.6,2.7,3.0,3.2,3.1,3.2,3.4,3.0,3.0,3.0","sankt augustin, stadt"
05382060,41016,20169,20847,05382060,9.4,6.0,3.4,4.0,7.6,4763,3137,1626,3846,2469,1377,11.6,"7.5,8.6,8.8,9.2,9.5,9.7,9.8,9.7,9.7,9.8,9.8,9.8,9.4","5.9,6.3,6.3,6.5,6.5,6.5,6.5,6.4,6.2,6.2,6.5,6.4,6.0","1.6,2.3,2.5,2.8,3.0,3.3,3.3,3.3,3.5,3.6,3.3,3.3,3.4","siegburg, stadt"
05382064,18204,8995,9209,05382064,9.0,5.9,3.1,1.9,3.9,1053,704,349,1631,1072,559,5.8,"6.7,8.0,8.0,8.1,8.5,8.8,9.1,9.1,9.0,9.4,9.5,9.3,9.0","5.5,6.1,5.8,5.8,6.0,6.1,6.3,6.3,6.0,6.2,6.4,6.2,5.9","1.2,1.8,2.1,2.2,2.5,2.7,2.8,2.9,3.0,3.2,3.1,3.1,3.1",swisttal
05382068,74400,36404,37996,05382068,9.9,6.3,3.6,3.5,6.4,7330,4747,2583,7369,4680,2689,9.9,"7.1,8.5,8.6,8.8,9.1,9.4,9.5,9.7,9.9,10.3,10.2,10.2,9.9","5.5,6.1,6.1,6.0,6.1,6.2,6.4,6.4,6.3,6.5,6.6,6.5,6.3","1.6,2.4,2.5,2.8,3.0,3.2,3.1,3.4,3.6,3.8,3.6,3.7,3.6","troisdorf, stadt"
05382072,20457,10090,10367,05382072,8.9,5.6,3.3,2.2,4.4,1340,891,449,1822,1151,671,6.6,"6.0,7.4,7.7,7.8,8.2,8.6,8.6,8.7,8.8,9.1,9.1,9.0,8.9","4.7,5.4,5.6,5.6,5.6,5.7,5.6,5.6,5.5,5.6,5.9,5.6,5.6","1.3,2.0,2.1,2.3,2.7,2.9,3.0,3.1,3.4,3.5,3.2,3.4,3.3",wachtberg
05382076,18931,9479,9452,05382076,9.2,6.6,2.6,1.8,4.6,1211,863,348,1738,1251,487,6.4,"6.4,7.1,7.2,7.1,7.4,7.8,7.8,7.9,8.1,8.9,9.2,9.2,9.2","5.4,5.8,5.8,5.5,5.7,5.8,5.7,5.9,5.9,6.4,6.8,6.8,6.6","1.0,1.4,1.4,1.6,1.8,2.0,2.0,2.0,2.2,2.4,2.3,2.3,2.6",windeck
05512000,117143,57004,60139,05512000,9.4,7.2,2.2,2.0,6.6,10060,7727,2333,10999,8402,2597,8.6,"7.3,8.5,8.4,8.9,9.1,9.3,9.5,9.8,9.9,9.8,9.9,9.8,9.4","6.3,6.9,6.9,7.2,7.2,7.2,7.4,7.5,7.6,7.4,7.7,7.6,7.2","1.0,1.5,1.6,1.7,1.9,2.1,2.1,2.3,2.3,2.4,2.2,2.2,2.2","bottrop, stadt"
05513000,260368,129267,131101,05513000,8.7,6.7,2.0,2.3,6.9,23828,17963,5865,22552,17336,5216,9.2,"6.8,8.0,7.8,8.1,8.3,8.5,8.9,9.0,9.0,8.7,8.9,8.9,8.7","5.8,6.5,6.3,6.5,6.5,6.5,6.8,6.9,6.9,6.6,7.0,6.9,6.7","1.0,1.5,1.5,1.6,1.8,1.9,2.0,2.1,2.1,2.1,2.0,2.0,2.0","gelsenkirchen, stadt"
05515000,310039,148447,161592,05515000,11.1,7.7,3.3,3.7,8.8,38622,27137,11485,34282,24009,10273,12.5,"8.1,9.8,10.1,10.3,10.6,10.9,11.2,11.0,11.2,11.3,11.1,11.3,11.1","6.1,7.0,7.1,7.3,7.4,7.4,7.5,7.3,7.4,7.4,7.8,8.0,7.7","2.0,2.8,3.0,3.0,3.2,3.5,3.7,3.7,3.8,3.9,3.3,3.4,3.3","münster, stadt"
05554004,39277,19613,19664,05554004,15.3,10.4,4.9,5.5,12.1,6940,4767,2173,6013,4092,1921,17.7,"10.9,12.2,12.4,12.8,13.5,14.1,14.5,14.7,15.2,15.4,15.7,15.6,15.3","9.1,9.7,9.6,9.7,10.1,10.2,10.5,10.5,10.5,10.5,10.9,10.8,10.4","1.8,2.5,2.8,3.1,3.4,3.9,4.0,4.2,4.6,4.9,4.8,4.9,4.9","ahaus, stadt"
05554008,71443,35039,36404,05554008,12.7,9.0,3.7,3.9,9.9,9831,7058,2773,9043,6411,2632,13.8,"9.6,10.9,10.8,11.1,11.5,11.8,12.3,12.4,12.6,13.0,12.9,12.9,12.7","7.7,8.3,8.2,8.4,8.5,8.7,9.1,9.1,8.9,9.2,9.4,9.3,9.0","1.9,2.6,2.6,2.7,2.9,3.1,3.2,3.4,3.6,3.8,3.5,3.6,3.7","bocholt, stadt"
05554012,42272,20803,21469,05554012,12.6,8.7,3.9,4.0,10.0,5896,4210,1686,5319,3659,1660,13.9,"9.5,10.7,11.2,11.7,11.9,12.2,12.4,12.4,12.9,12.7,12.7,13.0,12.6","7.9,8.4,8.6,8.9,8.9,9.0,9.1,9.1,9.0,8.8,9.1,9.1,8.7","1.7,2.3,2.6,2.8,3.0,3.2,3.3,3.4,3.8,3.9,3.6,3.9,3.9","borken, stadt"
05554016,17118,8644,8474,05554016,12.8,9.0,3.7,3.2,8.2,1962,1408,554,2184,1544,640,11.5,"9.5,10.6,10.5,11.0,11.4,11.7,11.8,12.0,12.5,12.8,13.1,12.9,12.8","7.8,8.5,8.2,8.7,8.7,8.8,8.8,8.9,9.1,9.0,9.6,9.2,9.0","1.6,2.2,2.3,2.3,2.8,2.9,3.1,3.1,3.4,3.8,3.5,3.7,3.7","gescher, glockenstadt"
05554020,47010,23468,23542,05554020,12.0,8.7,3.3,2.9,8.4,5339,3972,1367,5623,4084,1539,11.4,"9.7,10.5,10.3,10.9,11.3,11.6,11.8,11.9,12.3,12.7,12.6,12.5,12.0","8.4,8.8,8.4,8.6,8.9,8.9,9.0,8.9,9.0,9.2,9.4,9.1,8.7","1.3,1.7,2.0,2.3,2.4,2.7,2.8,3.0,3.3,3.5,3.2,3.3,3.3","gronau (westf.), stadt"
05554024,8505,4315,4190,05554024,14.3,10.1,4.3,3.8,8.7,1057,737,320,1218,856,362,12.4,"9.9,10.6,10.6,11.1,11.5,12.7,13.5,13.8,13.9,15.0,15.4,15.0,14.3","8.1,8.3,8.2,8.4,8.4,9.2,10.1,9.7,9.7,10.4,10.9,10.7,10.1","1.8,2.4,2.4,2.7,3.1,3.5,3.4,4.1,4.2,4.5,4.5,4.4,4.3",heek
05554028,8152,4127,4025,05554028,12.8,8.9,3.9,3.2,7.9,905,643,262,1041,727,314,11.1,"9.5,11.4,12.0,11.5,11.8,12.6,12.9,13.0,13.0,12.8,13.1,13.0,12.8","7.8,8.9,9.4,8.9,9.0,9.6,9.7,9.7,9.5,9.4,9.5,9.4,8.9","1.6,2.5,2.6,2.5,2.8,3.0,3.2,3.3,3.5,3.4,3.5,3.5,3.9",heiden
05554032,10736,5387,5349,05554032,13.4,9.5,3.9,2.9,7.5,1119,803,316,1437,1021,416,10.4,"10.1,11.2,11.1,11.7,12.1,12.6,13.3,13.1,13.5,14.1,13.6,13.4,13.4","8.3,8.8,8.4,8.9,8.9,9.2,9.8,9.6,9.6,10.0,9.8,9.7,9.5","1.7,2.4,2.7,2.8,3.2,3.3,3.5,3.5,3.9,4.0,3.8,3.7,3.9","isselburg, stadt"
05554036,7254,3794,3460,05554036,13.7,9.5,4.2,5.0,9.4,1046,680,366,997,689,308,14.4,"10.7,11.7,12.5,12.7,13.1,13.9,14.2,14.4,14.9,14.5,14.8,14.1,13.7","8.7,9.1,9.6,9.7,9.7,9.9,10.2,10.2,10.5,9.9,10.5,10.0,9.5","2.0,2.6,2.9,3.0,3.4,4.0,4.0,4.2,4.4,4.5,4.2,4.1,4.2",legden
05554040,11378,5735,5643,05554040,12.8,9.0,3.8,3.8,8.4,1382,953,429,1454,1024,430,12.1,"8.5,9.8,10.3,11.2,11.9,12.2,12.9,13.0,13.4,13.3,13.1,13.0,12.8","7.3,7.8,8.1,8.8,9.2,9.4,9.7,9.4,9.7,9.3,9.5,9.2,9.0","1.2,2.0,2.2,2.4,2.8,2.8,3.3,3.5,3.7,4.0,3.6,3.7,3.8",raesfeld
05554044,14532,7398,7134,05554044,12.0,8.3,3.6,3.0,7.0,1452,1011,441,1741,1212,529,10.0,"8.8,10.3,10.4,11.1,11.4,11.6,11.9,12.1,12.5,12.0,12.0,12.0,12.0","7.3,8.1,8.2,8.6,8.6,8.5,8.8,8.7,9.0,8.6,8.7,8.4,8.3","1.5,2.2,2.2,2.5,2.8,3.1,3.1,3.4,3.6,3.4,3.3,3.6,3.6",reken
05554048,19284,9622,9662,05554048,12.3,8.8,3.5,3.4,7.1,2031,1374,657,2370,1693,677,10.5,"9.2,10.6,11.0,11.5,11.8,11.7,12.3,12.6,12.6,12.7,13.0,12.9,12.3","7.5,8.3,8.5,8.9,9.0,8.8,9.1,9.3,9.2,9.1,9.5,9.4,8.8","1.7,2.3,2.5,2.7,2.8,2.9,3.1,3.3,3.4,3.6,3.5,3.5,3.5","rhede, stadt"
05554052,7280,3895,3385,05554052,12.7,8.7,4.0,4.1,8.2,892,597,295,921,633,288,12.3,"8.8,10.4,10.2,9.8,9.8,10.0,10.5,10.8,10.4,12.8,12.6,12.9,12.7","7.1,8.1,7.9,7.5,7.4,6.9,7.3,7.6,7.2,8.8,8.9,9.0,8.7","1.7,2.3,2.3,2.2,2.5,3.0,3.2,3.2,3.2,4.0,3.7,3.9,4.0",schöppingen
05554056,20411,10267,10144,05554056,15.3,10.0,5.2,5.3,10.2,3157,2072,1085,3119,2048,1071,15.5,"11.6,13.3,13.1,13.8,14.3,14.6,15.1,15.0,15.5,16.0,15.9,16.0,15.3","9.5,10.3,10.2,10.4,10.6,10.6,10.8,10.5,10.8,10.8,10.6,10.7,10.0","2.1,3.0,2.9,3.4,3.7,4.1,4.3,4.5,4.7,5.2,5.2,5.3,5.2","stadtlohn, stadt"
05554060,9134,4542,4592,05554060,13.9,9.5,4.4,4.4,9.1,1229,831,398,1271,869,402,13.5,"11.0,12.3,12.6,13.6,13.4,13.7,14.0,13.9,14.4,14.6,14.8,14.6,13.9","9.2,9.8,9.7,10.2,9.9,9.9,9.8,9.8,9.8,10.0,10.6,10.3,9.5","1.8,2.5,3.0,3.3,3.5,3.8,4.2,4.1,4.7,4.5,4.1,4.3,4.4",südlohn
05554064,13192,6737,6455,05554064,13.1,9.3,3.8,3.3,7.2,1388,948,440,1725,1225,500,10.5,"9.2,10.6,10.8,11.2,11.5,11.9,12.2,12.2,12.9,12.9,13.0,13.4,13.1","7.7,8.5,8.5,8.4,8.5,8.7,9.0,8.9,9.3,9.3,9.6,9.5,9.3","1.5,2.1,2.3,2.8,3.0,3.1,3.2,3.3,3.6,3.7,3.4,3.8,3.8","velen, stadt"
05554068,22688,11587,11101,05554068,16.4,10.9,5.5,5.2,9.8,3395,2223,1172,3720,2482,1238,15.0,"11.1,12.7,13.0,13.6,14.5,14.9,15.5,15.5,15.9,16.2,16.6,16.9,16.4","8.8,9.5,9.6,10.0,10.4,10.6,11.1,11.1,11.0,11.0,11.3,11.4,10.9","2.3,3.2,3.4,3.6,4.1,4.3,4.4,4.4,4.9,5.2,5.3,5.5,5.5","vreden, stadt"
05558004,15253,7618,7635,05558004,10.5,7.4,3.1,3.1,8.1,1707,1228,479,1600,1128,472,11.2,"7.5,8.8,9.1,9.5,10.0,10.2,10.6,10.7,10.9,11.0,10.9,10.9,10.5","6.2,6.9,7.0,7.2,7.5,7.4,7.8,7.6,7.7,7.6,7.7,7.7,7.4","1.3,2.0,2.1,2.4,2.5,2.8,2.9,3.1,3.2,3.4,3.2,3.2,3.1",ascheberg
05558008,11593,5812,5781,05558008,11.6,7.8,3.8,3.4,7.5,1267,875,392,1342,904,438,10.9,"8.3,9.5,9.4,9.6,10.0,10.7,11.1,11.1,11.1,11.3,11.6,11.2,11.6","6.9,7.3,7.3,7.2,7.5,7.9,7.9,7.6,7.7,7.7,8.1,7.6,7.8","1.3,2.1,2.1,2.4,2.5,2.8,3.2,3.4,3.5,3.6,3.5,3.7,3.8","billerbeck, stadt"
05558012,36116,17738,18378,05558012,11.9,8.0,3.8,4.0,9.0,4696,3268,1428,4286,2904,1382,13.0,"9.3,10.5,10.4,10.8,11.1,11.3,11.6,11.9,12.2,12.3,12.2,12.4,11.9","7.5,8.1,8.1,8.2,8.2,8.1,8.2,8.4,8.5,8.5,8.6,8.6,8.0","1.8,2.4,2.3,2.7,3.0,3.2,3.4,3.6,3.7,3.8,3.6,3.8,3.8","coesfeld, stadt"
05558016,46613,22685,23928,05558016,10.7,7.6,3.2,2.7,6.3,4214,2939,1275,5004,3522,1482,9.0,"8.1,9.3,9.5,9.9,10.2,10.7,10.7,10.9,11.1,11.1,11.3,11.1,10.7","6.7,7.3,7.4,7.5,7.7,7.9,7.9,7.9,7.8,7.8,8.1,8.0,7.6","1.4,2.0,2.2,2.4,2.5,2.8,2.8,2.9,3.2,3.4,3.2,3.2,3.2","dülmen, stadt"
05558020,11689,5732,5957,05558020,10.4,7.0,3.3,2.5,5.6,953,655,298,1210,820,390,8.2,"6.9,8.0,8.4,9.1,9.2,9.7,10.0,9.9,9.6,9.9,10.1,10.4,10.4","5.4,6.0,5.9,6.7,6.7,7.1,7.1,7.0,6.8,6.8,7.2,7.1,7.0","1.5,2.0,2.5,2.4,2.5,2.5,2.8,2.9,2.8,3.1,3.0,3.3,3.3",havixbeck
05558024,24263,12054,12209,05558024,10.6,7.4,3.1,3.1,7.9,2681,1919,762,2563,1805,758,11.0,"7.7,8.9,8.8,9.2,9.9,9.9,10.3,10.5,10.5,10.8,11.0,10.8,10.6","6.5,7.0,6.8,7.1,7.6,7.3,7.6,7.6,7.4,7.6,8.0,7.7,7.4","1.2,1.9,1.9,2.1,2.4,2.6,2.7,2.9,3.1,3.3,3.0,3.1,3.1","lüdinghausen, stadt"
05558028,9781,4845,4936,05558028,10.5,7.4,3.1,2.8,6.9,943,673,270,1026,724,302,9.6,"7.7,8.7,9.1,9.3,9.3,9.9,9.9,10.1,9.7,11.0,10.4,10.7,10.5","6.6,6.8,7.0,7.0,6.9,7.3,7.3,7.3,7.0,7.7,7.6,7.6,7.4","1.1,1.9,2.1,2.3,2.5,2.5,2.6,2.7,2.8,3.2,2.8,3.1,3.1",nordkirchen
05558032,19436,9641,9795,05558032,11.0,7.5,3.6,2.9,5.9,1704,1139,565,2143,1452,691,8.8,"8.1,9.3,9.4,9.7,10.3,10.5,10.7,10.8,10.8,11.0,11.1,11.1,11.0","6.4,6.9,6.9,7.1,7.3,7.3,7.5,7.5,7.4,7.4,7.7,7.7,7.5","1.7,2.4,2.5,2.5,3.0,3.2,3.2,3.3,3.4,3.6,3.4,3.5,3.6",nottuln
05558036,12490,6145,6345,05558036,10.0,7.2,2.8,2.7,6.5,1151,816,335,1250,905,345,9.2,"7.1,8.2,8.2,8.7,9.0,9.3,9.6,9.7,10.0,10.1,10.2,10.5,10.0","6.1,6.7,6.7,6.9,7.1,7.3,7.4,7.2,7.2,7.1,7.4,7.5,7.2","1.1,1.5,1.6,1.7,1.9,2.0,2.2,2.6,2.9,2.9,2.8,3.0,2.8","olfen, stadt"
05558040,10712,5507,5205,05558040,12.5,8.1,4.3,3.3,5.9,982,631,351,1337,872,465,9.2,"8.9,10.0,10.4,10.4,10.6,11.5,11.9,12.3,12.6,12.3,13.2,13.4,12.5","7.3,7.8,8.0,8.0,8.0,8.6,8.6,8.8,9.0,8.7,9.4,9.2,8.1","1.6,2.2,2.4,2.4,2.6,2.8,3.3,3.5,3.7,3.6,3.8,4.2,4.3",rosendahl
05558044,20455,10176,10279,05558044,10.8,7.2,3.6,2.7,5.6,1692,1137,555,2209,1482,727,8.3,"7.7,9.0,9.2,9.6,10.1,10.3,10.3,10.6,10.8,11.1,10.9,10.9,10.8","6.4,6.8,6.8,7.1,7.1,7.1,7.1,7.3,7.0,7.3,7.5,7.5,7.2","1.3,2.2,2.3,2.5,2.9,3.2,3.3,3.4,3.8,3.8,3.4,3.4,3.6",senden
05562004,74220,36210,38010,05562004,8.6,6.4,2.3,2.1,5.9,5944,4407,1537,6411,4719,1692,8.0,"7.1,8.1,8.1,8.4,8.5,8.7,9.1,9.1,9.1,9.3,9.1,9.1,8.6","6.1,6.5,6.5,6.6,6.5,6.6,6.9,6.9,6.8,6.8,7.0,6.9,6.4","1.0,1.6,1.6,1.8,2.0,2.1,2.2,2.2,2.3,2.4,2.1,2.2,2.3","castrop-rauxel, stadt"
05562008,34521,16922,17599,05562008,9.5,7.3,2.2,2.0,7.2,3152,2471,681,3277,2505,772,9.1,"7.1,8.4,8.3,8.8,8.9,9.2,9.3,9.4,9.3,9.6,9.5,9.7,9.5","6.1,7.0,6.8,7.1,7.0,7.1,7.2,7.2,7.1,7.3,7.4,7.5,7.3","1.0,1.5,1.5,1.8,2.0,2.1,2.1,2.2,2.2,2.4,2.0,2.1,2.2","datteln, stadt"
05562012,75431,36714,38717,05562012,10.4,7.9,2.5,2.3,7.1,7077,5333,1744,7808,5949,1859,9.4,"8.1,9.1,9.2,9.5,9.9,10.3,10.6,10.7,10.8,10.6,10.6,10.6,10.4","7.0,7.5,7.5,7.7,7.9,8.1,8.3,8.3,8.2,8.1,8.2,8.2,7.9","1.0,1.6,1.7,1.8,2.0,2.2,2.3,2.4,2.5,2.6,2.3,2.3,2.5","dorsten, stadt"
05562014,75455,36801,38654,05562014,9.5,7.4,2.2,1.7,6.2,5985,4686,1299,7205,5576,1629,7.9,"7.2,8.5,8.4,8.7,8.8,8.9,9.2,9.4,9.7,9.7,9.8,9.9,9.5","6.3,7.1,6.9,7.0,7.1,7.1,7.2,7.4,7.4,7.5,7.7,7.8,7.4","0.9,1.5,1.5,1.7,1.8,1.8,2.0,2.1,2.3,2.2,2.1,2.1,2.2","gladbeck, stadt"
05562016,38020,18535,19485,05562016,9.4,6.9,2.5,2.4,6.8,3506,2579,927,3587,2629,958,9.2,"7.5,8.5,8.6,8.9,9.0,9.0,9.3,9.6,9.4,9.5,9.5,9.6,9.4","6.4,6.9,6.9,7.0,7.0,6.8,6.9,7.1,6.9,7.1,7.2,7.1,6.9","1.1,1.6,1.8,1.9,2.0,2.2,2.3,2.5,2.5,2.5,2.3,2.5,2.5","haltern am see, stadt"
05562020,61163,29875,31288,05562020,9.0,7.0,2.0,1.6,5.9,4534,3580,954,5493,4298,1195,7.4,"7.3,8.2,8.4,8.6,8.9,8.9,9.2,9.2,9.4,9.3,9.3,9.3,9.0","6.3,6.9,6.9,6.9,7.1,7.0,7.0,7.1,7.2,7.1,7.4,7.4,7.0","1.0,1.4,1.5,1.6,1.8,1.9,2.1,2.1,2.2,2.2,1.9,2.0,2.0","herten, stadt"
05562024,83926,41288,42638,05562024,9.2,7.1,2.1,2.0,6.6,7211,5549,1662,7707,5980,1727,8.6,"7.3,8.3,8.3,8.6,9.0,9.3,9.6,9.6,9.6,9.8,9.6,9.6,9.2","6.4,6.8,6.8,6.9,7.3,7.3,7.5,7.5,7.4,7.5,7.6,7.6,7.1","1.0,1.5,1.5,1.6,1.7,2.0,2.1,2.1,2.2,2.3,2.0,2.0,2.1","marl, stadt"
05562028,31387,15553,15834,05562028,8.5,6.7,1.8,1.2,4.2,1685,1321,364,2668,2108,560,5.4,"7.6,8.8,8.8,9.0,9.2,9.6,9.7,9.5,9.4,9.1,8.7,8.9,8.5","6.5,7.2,7.2,7.2,7.2,7.3,7.5,7.4,7.2,6.9,6.9,7.0,6.7","1.0,1.6,1.6,1.8,2.0,2.3,2.2,2.1,2.2,2.2,1.8,1.9,1.8","oer-erkenschwick, stadt"
05562032,114330,55697,58633,05562032,9.4,7.1,2.2,2.1,6.7,10045,7650,2395,10707,8143,2564,8.8,"7.2,8.4,8.3,8.5,8.7,8.8,9.0,9.2,9.2,9.4,9.3,9.6,9.4","6.1,6.8,6.7,6.7,6.8,6.8,7.0,7.0,7.0,7.1,7.2,7.4,7.1","1.1,1.6,1.6,1.7,1.9,2.0,2.1,2.2,2.3,2.3,2.1,2.2,2.2","recklinghausen, stadt"
05562036,29354,14298,15056,05562036,9.5,7.2,2.3,1.7,6.1,2292,1800,492,2802,2117,685,7.8,"7.8,8.8,8.9,9.0,9.2,9.4,9.6,9.7,9.8,9.8,9.7,9.9,9.5","6.8,7.3,7.3,7.3,7.2,7.3,7.5,7.4,7.5,7.5,7.6,7.7,7.2","1.0,1.5,1.6,1.7,1.9,2.1,2.1,2.2,2.3,2.3,2.1,2.2,2.3","waltrop, stadt"
05566004,10315,5201,5114,05566004,10.4,7.0,3.5,3.3,6.1,975,634,341,1075,718,357,9.5,"7.7,9.0,9.3,9.7,10.1,9.9,10.5,10.4,10.2,10.5,10.6,10.5,10.4","6.2,6.7,6.7,6.8,7.2,6.8,7.0,6.9,6.7,6.9,7.2,6.8,7.0","1.6,2.2,2.6,2.9,2.9,3.1,3.5,3.5,3.6,3.6,3.4,3.7,3.5",altenberge
05566008,36320,18009,18311,05566008,12.1,8.2,3.9,4.0,8.6,4573,3136,1437,4412,2979,1433,12.6,"10.3,11.4,11.1,11.5,11.9,12.4,12.3,12.2,12.6,12.5,12.7,12.7,12.1","8.4,8.9,8.5,8.7,8.8,8.9,8.9,8.6,8.8,8.5,8.9,8.7,8.2","1.9,2.5,2.6,2.9,3.0,3.4,3.4,3.6,3.8,4.0,3.8,4.0,3.9","emsdetten, stadt"
05566012,36674,18087,18587,05566012,11.1,7.3,3.8,4.2,8.5,4660,3108,1552,4072,2684,1388,12.7,"8.5,9.6,9.7,9.9,10.3,10.5,10.6,10.9,11.2,11.8,11.7,11.6,11.1","6.5,7.1,7.1,7.1,7.2,7.2,7.3,7.5,7.5,7.8,8.0,7.8,7.3","1.9,2.5,2.6,2.8,3.1,3.3,3.3,3.4,3.7,4.0,3.7,3.7,3.8","greven, stadt"
05566016,19995,10048,9947,05566016,12.6,8.8,3.8,3.2,7.8,2191,1554,637,2515,1760,755,11.0,"9.2,10.6,11.0,11.4,12.0,12.3,12.3,12.3,12.6,12.7,12.8,12.7,12.6","7.6,8.4,8.5,8.6,9.0,9.2,9.1,8.8,8.8,8.9,9.0,9.1,8.8","1.6,2.2,2.4,2.8,3.1,3.0,3.2,3.6,3.8,3.8,3.7,3.7,3.8","hörstel, stadt"
05566020,7642,3973,3669,05566020,14.0,9.6,4.4,3.6,7.2,828,551,277,1072,732,340,10.8,"10.2,11.5,12.3,12.9,13.1,13.3,13.4,13.7,13.9,14.2,13.7,14.2,14.0","8.3,9.1,9.7,9.9,10.0,9.9,9.8,9.7,9.6,9.6,9.3,9.6,9.6","1.9,2.5,2.6,3.0,3.0,3.4,3.6,4.0,4.3,4.6,4.3,4.5,4.4",hopsten
05566024,6447,3274,3173,05566024,10.8,7.8,3.0,2.4,6.7,583,431,152,696,501,195,9.0,"8.6,10.3,10.7,11.0,10.9,11.1,11.5,11.5,12.0,11.2,11.6,11.8,10.8","7.2,8.4,8.5,8.6,8.6,8.7,8.7,8.4,8.7,8.0,8.5,8.5,7.8","1.4,2.0,2.2,2.3,2.3,2.5,2.8,3.1,3.3,3.2,3.1,3.3,3.0","horstmar, stadt der burgmannshöfe"
05566028,50935,25176,25759,05566028,12.0,8.4,3.6,3.6,8.6,6210,4396,1814,6097,4281,1816,12.2,"9.1,10.5,10.6,10.9,11.3,11.6,11.8,11.7,11.8,12.2,12.1,12.1,12.0","7.6,8.3,8.3,8.3,8.4,8.4,8.4,8.3,8.3,8.5,8.6,8.5,8.4","1.5,2.2,2.3,2.6,2.9,3.2,3.3,3.4,3.5,3.8,3.4,3.6,3.6","ibbenbüren, stadt"
05566032,6694,3321,3373,05566032,11.3,7.1,4.3,3.8,7.5,758,504,254,757,472,285,11.3,"7.8,9.3,9.7,9.8,10.3,10.7,11.7,11.5,11.8,12.1,11.6,11.6,11.3","6.4,6.9,7.2,7.0,7.1,7.4,8.1,7.8,7.7,8.0,7.7,7.4,7.1","1.5,2.4,2.5,2.8,3.2,3.4,3.6,3.7,4.1,4.1,4.0,4.3,4.3",ladbergen
05566036,6721,3370,3351,05566036,10.6,7.4,3.2,2.6,6.3,595,423,172,713,499,214,8.9,"9.5,10.7,10.7,10.7,10.8,11.3,12.0,11.1,11.6,11.1,10.9,10.5,10.6","7.8,8.3,8.3,8.3,8.4,8.3,8.8,8.2,8.0,7.7,7.7,7.4,7.4","1.7,2.4,2.4,2.4,2.4,3.0,3.2,2.9,3.6,3.4,3.2,3.1,3.2",laer
05566040,22461,11129,11332,05566040,10.6,7.1,3.5,2.9,6.0,2014,1352,662,2373,1590,783,9.0,"7.8,9.2,9.1,9.7,10.4,10.2,10.2,10.4,10.7,11.0,10.7,10.8,10.6","6.1,6.8,6.8,6.9,7.4,7.0,7.0,7.1,7.2,7.3,7.4,7.3,7.1","1.7,2.4,2.4,2.8,3.0,3.2,3.2,3.3,3.6,3.7,3.3,3.5,3.5","lengerich, stadt"
05566044,8559,4316,4243,05566044,10.8,7.2,3.6,2.3,5.0,621,424,197,921,616,305,7.3,"7.9,8.9,8.9,9.4,9.8,9.8,10.0,10.1,10.6,10.8,10.5,11.0,10.8","6.6,6.9,6.8,7.0,7.2,7.1,7.0,7.0,7.0,7.2,7.2,7.4,7.2","1.3,2.0,2.1,2.4,2.6,2.8,3.0,3.0,3.6,3.6,3.3,3.6,3.6",lienen
05566048,14175,7094,7081,05566048,12.5,8.0,4.5,2.0,3.2,738,456,282,1771,1128,643,5.2,"8.3,9.5,9.6,10.3,10.8,11.3,11.4,11.5,11.8,12.2,12.3,12.2,12.5","6.4,7.0,7.0,7.4,7.6,7.6,7.5,7.3,7.5,7.7,7.7,7.7,8.0","1.9,2.5,2.6,2.9,3.2,3.7,3.9,4.2,4.4,4.5,4.6,4.5,4.5",lotte
05566052,6461,3262,3199,05566052,11.6,8.3,3.3,2.3,5.3,488,341,147,748,537,211,7.6,"9.7,11.1,10.8,11.2,11.7,11.8,12.7,12.8,12.1,12.4,12.4,11.9,11.6","8.4,9.2,8.7,8.8,9.4,9.3,10.0,9.7,8.8,9.3,9.3,8.8,8.3","1.4,1.9,2.1,2.4,2.3,2.4,2.7,3.1,3.3,3.1,3.1,3.1,3.3",metelen
05566056,11815,5875,5940,05566056,12.8,9.1,3.7,2.5,6.9,1118,821,297,1510,1074,436,9.5,"9.2,10.9,11.1,10.9,11.3,11.5,11.9,12.1,12.4,12.8,12.9,12.9,12.8","7.8,8.6,8.8,8.6,8.6,8.8,8.9,9.0,9.1,9.4,9.8,9.4,9.1","1.4,2.3,2.3,2.4,2.7,2.7,2.9,3.1,3.3,3.4,3.2,3.5,3.7",mettingen
05566060,13743,6908,6835,05566060,13.1,9.4,3.7,3.5,8.8,1688,1209,479,1806,1297,509,12.3,"9.4,10.9,11.1,11.7,12.5,12.7,13.1,13.3,13.6,13.6,13.7,13.6,13.1","7.8,8.6,8.6,8.8,9.2,9.4,9.6,9.8,10.0,9.8,10.4,9.9,9.4","1.7,2.3,2.6,2.9,3.3,3.3,3.4,3.5,3.7,3.8,3.3,3.7,3.7",neuenkirchen
05566064,9388,4650,4738,05566064,12.1,8.3,3.8,3.7,7.3,1039,689,350,1137,777,360,11.1,"8.9,10.1,10.4,10.3,10.4,11.2,11.7,11.7,12.1,12.1,12.2,12.5,12.1","7.5,7.9,8.1,7.9,8.0,8.1,8.4,8.4,8.4,8.4,8.7,8.5,8.3","1.5,2.2,2.4,2.3,2.5,3.1,3.3,3.3,3.8,3.6,3.5,4.0,3.8",nordwalde
05566068,19599,9922,9677,05566068,12.9,8.9,4.0,3.4,8.2,2272,1607,665,2530,1751,779,11.6,"8.9,10.3,10.7,11.2,11.6,12.0,11.8,12.1,12.6,13.0,13.5,13.6,12.9","7.3,8.0,8.2,8.4,8.6,8.7,8.5,8.6,8.7,8.9,9.7,9.6,8.9","1.6,2.3,2.5,2.7,3.0,3.3,3.3,3.5,3.9,4.1,3.8,4.0,4.0","ochtrup, stadt"
05566072,11363,5661,5702,05566072,14.9,10.7,4.2,4.2,10.7,1694,1213,481,1693,1213,480,14.9,"9.8,11.5,11.8,11.9,12.3,12.7,13.3,13.6,13.8,14.4,14.4,14.8,14.9","8.1,9.1,9.5,9.2,9.3,9.6,9.8,10.1,10.1,10.4,10.6,10.6,10.7","1.6,2.5,2.4,2.8,2.9,3.0,3.5,3.5,3.7,4.0,3.8,4.1,4.2",recke
05566076,74852,36911,37941,05566076,11.8,8.3,3.5,3.6,8.6,9137,6447,2690,8829,6184,2645,12.2,"9.4,10.7,10.6,11.0,11.6,11.8,11.6,11.6,11.8,12.2,12.1,12.0,11.8","7.8,8.5,8.4,8.5,8.8,8.8,8.6,8.5,8.5,8.5,8.8,8.5,8.3","1.6,2.2,2.3,2.5,2.8,3.0,3.0,3.1,3.3,3.6,3.3,3.5,3.5","rheine, stadt"
05566080,7191,3639,3552,05566080,12.1,8.0,4.1,4.9,7.1,859,509,350,871,573,298,11.9,"9.0,9.9,10.1,10.2,10.5,11.3,11.6,11.0,12.0,12.0,12.8,12.9,12.1","7.1,7.5,7.2,7.2,7.5,8.1,7.8,7.5,8.1,8.2,8.9,8.7,8.0","1.9,2.4,2.9,2.9,3.1,3.2,3.7,3.5,3.9,3.8,3.9,4.2,4.1","saerbeck, nrw-klimakommune"
05566084,33682,16719,16963,05566084,11.8,8.4,3.4,3.1,8.4,3854,2817,1037,3980,2836,1144,11.4,"9.8,10.7,10.6,10.9,11.1,11.7,11.8,12.0,12.1,12.3,12.5,12.6,11.8","8.1,8.3,8.4,8.3,8.4,8.7,8.8,8.7,8.7,8.7,9.2,9.2,8.4","1.7,2.3,2.2,2.6,2.7,2.9,3.0,3.3,3.4,3.5,3.4,3.4,3.4","steinfurt, stadt"
05566088,9062,4573,4489,05566088,10.4,7.1,3.2,3.6,7.0,959,636,323,938,647,291,10.6,"7.9,9.2,9.5,10.2,10.3,10.4,9.8,10.1,10.4,10.4,10.4,10.6,10.4","6.7,7.0,7.2,7.7,7.6,7.5,7.2,7.1,7.3,7.3,7.6,7.6,7.1","1.2,2.2,2.2,2.5,2.7,2.9,2.7,3.0,3.1,3.1,2.9,3.0,3.2","tecklenburg, stadt"
05566092,11178,5582,5596,05566092,11.5,7.8,3.8,4.8,8.9,1529,998,531,1287,867,420,13.7,"8.5,9.8,10.1,10.1,10.3,10.6,10.9,11.4,11.4,11.7,11.6,11.5,11.5","6.9,7.5,7.9,7.6,7.6,7.7,7.8,7.9,7.8,7.9,8.1,8.0,7.8","1.6,2.3,2.1,2.5,2.8,2.9,3.1,3.5,3.6,3.9,3.5,3.5,3.8",westerkappeln
05566096,8102,4082,4020,05566096,13.0,9.3,3.7,4.1,8.7,1034,701,333,1057,756,301,12.8,"8.7,10.5,10.8,10.9,12.2,12.4,12.9,12.4,12.5,12.6,13.0,13.0,13.0","7.2,8.1,8.3,8.4,9.3,9.3,9.5,9.0,8.8,8.9,9.4,9.3,9.3","1.5,2.4,2.5,2.5,2.9,3.1,3.4,3.4,3.7,3.7,3.6,3.7,3.7",wettringen
05570004,52287,25551,26736,05570004,11.0,8.2,2.8,2.5,7.5,5213,3898,1315,5748,4282,1466,10.0,"8.1,9.1,9.4,9.5,10.0,10.3,10.6,10.9,11.1,11.2,11.3,11.2,11.0","6.8,7.3,7.4,7.4,7.6,7.7,7.9,8.0,7.9,8.1,8.6,8.5,8.2","1.3,1.8,1.9,2.1,2.3,2.6,2.7,2.9,3.1,3.1,2.7,2.7,2.8","ahlen, stadt"
05570008,36560,18089,18471,05570008,10.9,7.6,3.4,3.6,7.2,3949,2642,1307,3997,2762,1235,10.8,"8.4,9.8,9.9,10.4,10.7,11.0,11.0,11.1,11.3,11.5,11.4,11.3,10.9","6.9,7.4,7.4,7.7,7.7,7.7,7.8,7.8,7.7,7.8,8.1,7.9,7.6","1.5,2.3,2.5,2.8,3.0,3.3,3.2,3.3,3.6,3.7,3.3,3.4,3.4","beckum, stadt"
05570012,6380,3217,3163,05570012,13.2,8.9,4.4,3.8,6.3,643,403,240,844,566,278,10.1,"9.5,11.3,11.5,11.0,12.2,13.3,13.3,14.1,13.8,13.6,14.1,14.0,13.2","7.6,8.7,8.3,8.0,8.8,9.1,9.3,9.8,9.8,9.0,9.6,9.3,8.9","1.9,2.5,3.2,3.0,3.4,4.2,4.0,4.4,3.9,4.6,4.5,4.7,4.4",beelen
05570016,15542,7757,7785,05570016,9.7,6.9,2.9,2.3,5.5,1204,852,352,1513,1067,446,7.7,"6.9,8.3,8.5,9.0,9.3,9.3,9.6,9.4,9.8,10.1,10.1,10.0,9.7","5.7,6.5,6.6,6.8,6.9,6.8,7.0,6.8,6.9,7.0,7.3,7.1,6.9","1.1,1.8,1.9,2.2,2.4,2.5,2.6,2.7,2.9,3.1,2.8,3.0,2.9","drensteinfurt, stadt"
05570020,20037,10075,9962,05570020,10.8,7.3,3.4,2.5,5.6,1615,1123,492,2156,1468,688,8.1,"7.9,9.0,9.1,9.9,10.3,10.7,11.0,11.1,11.7,11.5,11.3,11.6,10.8","6.4,7.0,7.0,7.3,7.4,7.6,7.8,7.6,8.2,7.9,7.9,8.1,7.3","1.4,2.1,2.2,2.6,2.9,3.2,3.3,3.4,3.5,3.6,3.5,3.5,3.4","ennigerloh, stadt"
05570024,9583,4766,4817,05570024,10.4,6.6,3.8,4.6,6.5,1069,626,443,999,633,366,11.2,"7.7,8.6,9.2,9.6,10.3,10.0,10.4,10.6,10.3,10.6,10.6,10.6,10.4","6.0,6.4,6.8,7.0,7.5,7.1,7.2,7.1,6.7,6.8,7.0,7.0,6.6","1.7,2.2,2.4,2.6,2.8,2.8,3.2,3.5,3.7,3.8,3.6,3.7,3.8",everswinkel
05570028,29299,14660,14639,05570028,11.2,7.6,3.6,3.0,7.0,2936,2060,876,3296,2235,1061,10.0,"8.9,10.2,10.4,10.8,10.5,10.7,10.9,11.1,11.4,11.7,11.7,11.7,11.2","7.2,7.8,7.8,8.0,7.6,7.4,7.6,7.7,7.9,7.9,8.1,8.2,7.6","1.7,2.4,2.6,2.9,2.9,3.2,3.3,3.4,3.5,3.8,3.6,3.5,3.6","oelde, stadt"
05570032,10873,5438,5435,05570032,12.1,7.8,4.3,3.7,6.3,1088,689,399,1314,843,471,10.0,"8.5,9.8,9.7,10.7,10.6,11.1,11.7,11.7,12.0,12.3,12.1,12.0,12.1","6.9,7.4,7.2,7.8,7.6,7.8,8.0,7.9,8.0,8.2,8.1,8.0,7.8","1.6,2.5,2.5,2.9,3.0,3.3,3.6,3.8,4.0,4.1,4.1,3.9,4.3",ostbevern
05570036,14403,7263,7140,05570036,12.7,7.8,4.9,3.4,5.4,1267,781,486,1835,1123,712,8.8,"9.2,10.4,10.5,11.4,12.0,12.2,12.6,12.2,12.7,12.9,13.2,13.2,12.7","7.2,7.7,7.7,8.1,8.1,8.1,8.3,8.2,8.3,8.1,8.6,8.3,7.8","2.0,2.7,2.8,3.3,3.9,4.2,4.3,4.0,4.4,4.7,4.6,4.9,4.9","sassenberg, stadt"
05570040,13218,6583,6635,05570040,11.9,8.1,3.8,2.9,6.8,1285,897,388,1577,1077,500,9.7,"7.9,9.0,9.1,9.5,9.7,10.0,10.5,10.7,11.3,11.4,11.5,11.6,11.9","6.3,6.8,7.0,7.1,7.0,7.1,7.5,7.4,7.4,7.5,7.8,7.9,8.1","1.6,2.1,2.1,2.4,2.8,2.9,3.0,3.3,3.9,4.0,3.6,3.7,3.8","sendenhorst, stadt"
05570044,19557,9461,10096,05570044,10.6,7.0,3.6,3.5,6.7,1982,1307,675,2077,1371,706,10.1,"8.2,9.4,9.5,9.7,9.8,10.4,10.4,10.4,10.8,11.2,10.7,10.5,10.6","6.6,7.1,7.1,7.0,7.0,7.2,7.1,7.0,7.2,7.4,7.4,7.0,7.0","1.6,2.4,2.4,2.7,2.8,3.2,3.3,3.3,3.5,3.9,3.4,3.5,3.6","telgte, stadt"
05570048,12443,6318,6125,05570048,12.0,8.2,3.8,3.6,6.6,1270,823,447,1494,1022,472,10.2,"8.7,10.3,10.5,11.1,11.5,12.1,12.2,12.1,12.0,12.6,12.4,12.3,12.0","7.2,8.0,8.1,8.2,8.4,8.6,8.7,8.4,8.2,8.7,8.8,8.6,8.2","1.6,2.3,2.5,2.9,3.1,3.5,3.6,3.7,3.8,3.9,3.6,3.7,3.8",wadersloh
05570052,37249,18087,19162,05570052,12.0,7.9,4.1,3.9,8.8,4748,3286,1462,4461,2936,1525,12.7,"8.5,9.5,9.6,10.0,10.7,10.9,11.4,11.4,11.7,12.0,12.1,12.2,12.0","6.8,7.1,7.1,7.3,7.6,7.7,7.9,7.8,7.8,7.9,8.2,8.2,7.9","1.7,2.4,2.4,2.7,3.1,3.2,3.5,3.5,3.8,4.1,3.9,4.0,4.1","warendorf, stadt"
05711000,333090,161148,171942,05711000,9.5,6.4,3.1,3.6,7.2,36045,23988,12057,31661,21417,10244,10.8,"7.0,8.4,8.5,8.7,9.0,9.1,9.2,9.3,9.6,9.4,9.3,9.6,9.5","5.4,6.0,6.0,6.1,6.1,6.0,6.0,6.1,6.2,6.0,6.4,6.6,6.4","1.7,2.4,2.5,2.6,2.9,3.1,3.1,3.2,3.3,3.4,2.9,3.0,3.1","bielefeld, stadt"
05754004,8801,4357,4444,05754004,10.3,6.5,3.7,3.3,5.0,733,441,292,904,574,330,8.3,"7.7,8.8,8.6,9.2,9.6,10.2,10.6,10.2,10.4,10.5,10.1,10.1,10.3","6.1,6.5,6.3,6.6,6.6,7.0,7.0,6.7,6.7,6.8,6.8,6.8,6.5","1.7,2.3,2.2,2.6,3.1,3.2,3.6,3.5,3.7,3.7,3.3,3.3,3.7","borgholzhausen, stadt"
05754008,97586,48366,49220,05754008,10.2,6.6,3.6,3.5,7.1,10352,6956,3396,9990,6456,3534,10.6,"7.6,8.8,8.8,9.1,9.4,9.7,9.7,9.9,10.0,10.2,10.3,10.5,10.2","5.9,6.4,6.3,6.4,6.3,6.4,6.4,6.5,6.4,6.5,6.9,7.0,6.6","1.7,2.4,2.5,2.7,3.0,3.3,3.4,3.4,3.6,3.7,3.5,3.6,3.6","gütersloh, stadt"
05754012,21709,10770,10939,05754012,9.9,6.2,3.7,3.7,8.6,2672,1873,799,2145,1342,803,12.3,"7.3,8.6,8.7,9.1,9.4,9.6,9.3,9.7,9.4,9.8,10.0,10.4,9.9","5.6,6.2,6.2,6.3,6.3,6.1,6.1,6.3,6.1,6.2,6.5,6.7,6.2","1.7,2.4,2.6,2.8,3.1,3.5,3.2,3.5,3.4,3.6,3.6,3.7,3.7","halle (westf.), stadt"
05754016,24769,12571,12198,05754016,11.5,7.5,4.0,4.4,7.9,3045,1961,1084,2847,1867,980,12.3,"8.3,9.6,10.1,10.4,10.8,11.0,11.4,11.4,11.6,11.9,12.1,11.9,11.5","6.7,7.2,7.4,7.4,7.5,7.5,7.9,7.8,7.8,7.7,8.1,8.0,7.5","1.6,2.4,2.7,3.0,3.3,3.5,3.5,3.6,3.8,4.2,4.0,3.9,4.0","harsewinkel, die mähdrescherstadt"
05754020,15965,7982,7983,05754020,12.3,8.1,4.1,3.6,6.9,1680,1108,572,1962,1301,661,10.5,"9.3,10.9,11.0,11.4,11.8,12.1,12.0,12.4,12.4,12.2,12.3,12.3,12.3","7.4,8.0,7.9,8.1,8.2,8.4,8.2,8.4,8.3,8.2,8.5,8.3,8.1","1.9,2.9,3.2,3.3,3.6,3.7,3.8,4.0,4.0,4.0,3.8,4.0,4.1",herzebrock-clarholz
05754024,8375,4236,4139,05754024,11.8,7.2,4.6,3.3,5.4,726,451,275,988,605,383,8.7,"9.5,10.6,11.0,12.1,12.1,12.4,12.5,12.2,12.6,12.4,12.5,12.4,11.8","7.7,8.1,8.4,9.0,8.7,8.7,8.8,8.3,8.3,8.0,8.2,7.8,7.2","1.8,2.5,2.6,3.1,3.4,3.7,3.7,3.9,4.2,4.5,4.3,4.5,4.6",langenberg
05754028,48000,23902,24098,05754028,11.3,7.2,4.1,4.3,7.3,5571,3522,2049,5407,3457,1950,11.6,"8.2,9.5,9.9,10.3,10.3,10.5,10.7,10.7,10.9,11.3,11.4,11.5,11.3","6.4,6.9,7.1,7.2,7.2,7.2,7.3,7.2,7.3,7.4,7.6,7.6,7.2","1.8,2.6,2.8,3.1,3.1,3.3,3.4,3.5,3.6,3.9,3.8,3.9,4.1","rheda-wiedenbrück, stadt"
05754032,29436,14901,14535,05754032,13.2,8.5,4.7,4.9,8.5,3939,2494,1445,3894,2512,1382,13.4,"9.8,11.1,11.2,11.8,12.1,12.9,12.8,12.9,13.3,13.5,13.7,13.4,13.2","7.9,8.3,8.2,8.5,8.5,8.8,8.8,8.7,8.8,8.8,9.1,8.8,8.5","1.9,2.8,3.0,3.3,3.6,4.1,4.0,4.3,4.5,4.7,4.6,4.6,4.7","rietberg, stadt"
05754036,27092,13435,13657,05754036,11.1,7.3,3.8,3.4,5.9,2514,1598,916,3005,1989,1016,9.3,"8.5,10.0,10.3,10.7,10.9,10.9,11.0,11.1,11.5,11.4,11.1,11.2,11.1","6.7,7.3,7.3,7.5,7.6,7.4,7.5,7.4,7.7,7.5,7.6,7.5,7.3","1.8,2.6,2.9,3.2,3.3,3.5,3.5,3.7,3.8,3.9,3.5,3.7,3.8","schloß holte-stukenbrock, stadt"
05754040,20749,10242,10507,05754040,10.1,6.6,3.5,5.3,9.8,3121,2029,1092,2097,1370,727,15.0,"7.9,9.1,9.2,9.7,9.9,10.1,10.2,10.3,10.3,10.3,10.3,10.3,10.1","6.3,6.7,6.7,6.8,6.8,6.7,6.8,6.8,6.7,6.6,7.1,6.9,6.6","1.7,2.4,2.5,2.9,3.1,3.4,3.4,3.6,3.7,3.7,3.2,3.4,3.5",steinhagen
05754044,25512,13060,12452,05754044,11.3,7.4,3.9,4.6,7.7,3146,1967,1179,2893,1891,1002,12.3,"8.4,9.2,9.9,10.3,10.3,10.6,10.5,10.7,10.7,11.1,11.2,11.4,11.3","6.7,6.9,7.1,7.2,7.4,7.1,7.1,7.1,6.9,7.2,7.5,7.6,7.4","1.7,2.3,2.8,3.0,3.0,3.5,3.4,3.6,3.8,3.9,3.7,3.8,3.9","verl, stadt"
05754048,21230,10686,10544,05754048,12.1,7.2,4.9,4.8,6.3,2364,1335,1029,2572,1536,1036,11.1,"8.8,10.6,10.7,11.2,11.9,12.2,12.1,12.2,12.5,12.4,12.2,12.0,12.1","6.6,7.5,7.5,7.5,7.7,7.7,7.6,7.6,7.7,7.5,7.6,7.3,7.2","2.3,3.1,3.2,3.7,4.2,4.5,4.4,4.6,4.8,4.9,4.6,4.7,4.9","versmold, stadt"
05754052,11418,5714,5704,05754052,9.5,6.3,3.2,2.8,5.1,896,579,317,1090,725,365,7.8,"7.2,8.3,8.2,8.8,9.1,8.9,9.3,9.3,9.5,9.4,9.6,9.6,9.5","5.8,6.2,6.0,6.4,6.2,5.9,6.3,6.1,6.3,6.0,6.5,6.5,6.3","1.4,2.0,2.2,2.4,2.9,3.0,3.0,3.2,3.2,3.4,3.1,3.1,3.2","werther (westf.), stadt"
05758004,45615,22277,23338,05758004,9.6,6.1,3.5,2.9,6.0,4074,2750,1324,4379,2801,1578,8.9,"7.8,9.1,9.6,9.7,10.2,10.4,10.2,10.3,10.4,10.2,9.9,10.0,9.6","6.0,6.5,6.8,6.8,6.9,7.0,6.8,6.8,6.6,6.4,6.5,6.5,6.1","1.8,2.7,2.8,2.9,3.3,3.4,3.4,3.5,3.8,3.8,3.4,3.4,3.5","bünde, stadt"
05758008,20658,10193,10465,05758008,9.2,5.8,3.4,3.2,4.7,1633,976,657,1898,1195,703,7.9,"6.6,7.9,8.2,8.6,8.9,9.3,9.2,9.7,9.5,9.4,9.4,9.3,9.2","5.2,5.6,5.8,6.1,6.2,6.3,6.2,6.4,6.2,6.2,6.3,6.2,5.8","1.4,2.3,2.4,2.5,2.7,3.0,3.0,3.3,3.3,3.3,3.0,3.2,3.4","enger, widukindstadt"
05758012,66521,32485,34036,05758012,9.2,6.0,3.1,3.7,7.0,7099,4636,2463,6106,4022,2084,10.7,"6.9,8.4,8.7,8.9,9.1,9.3,9.3,9.6,9.9,9.7,9.5,9.4,9.2","5.5,6.2,6.2,6.2,6.2,6.3,6.2,6.2,6.3,6.1,6.3,6.2,6.0","1.5,2.3,2.5,2.7,2.9,3.1,3.1,3.4,3.6,3.6,3.1,3.2,3.1","herford, hansestadt"
05758016,19758,9805,9953,05758016,8.5,5.3,3.2,2.5,4.5,1380,894,486,1679,1044,635,7.0,"6.4,7.6,8.1,8.4,8.6,8.8,8.6,8.9,9.0,9.0,8.7,8.8,8.5","5.1,5.7,5.9,6.1,6.0,6.1,5.8,6.0,5.9,5.9,5.8,5.7,5.3","1.3,1.9,2.1,2.4,2.6,2.7,2.8,2.9,3.1,3.2,2.9,3.1,3.2",hiddenhausen
05758020,16085,7896,8189,05758020,8.9,6.0,2.9,3.2,5.9,1460,952,508,1436,962,474,9.1,"7.1,8.2,8.7,9.0,9.5,9.9,9.7,9.9,9.9,9.6,9.8,9.6,8.9","5.6,6.1,6.2,6.4,6.7,6.8,6.5,6.6,6.5,6.4,6.9,6.5,6.0","1.6,2.2,2.5,2.6,2.8,3.1,3.2,3.3,3.4,3.1,2.9,3.1,2.9",kirchlengern
05758024,40086,19759,20327,05758024,9.2,6.1,3.1,2.2,4.8,2820,1929,891,3673,2435,1238,7.0,"7.7,8.7,8.8,8.9,9.3,9.6,9.7,9.5,9.8,9.9,9.5,9.4,9.2","6.0,6.3,6.3,6.2,6.3,6.4,6.5,6.4,6.2,6.3,6.4,6.3,6.1","1.6,2.4,2.6,2.7,3.0,3.2,3.2,3.2,3.5,3.6,3.1,3.1,3.1","löhne, stadt"
05758028,9717,4841,4876,05758028,9.9,6.2,3.7,2.9,5.0,774,489,285,962,606,356,8.0,"6.7,8.3,8.3,8.5,9.2,8.9,9.3,9.5,9.5,10.0,10.0,10.2,9.9","5.2,6.2,6.1,6.1,6.6,6.4,6.6,6.6,6.4,6.6,6.6,6.8,6.2","1.4,2.1,2.1,2.4,2.7,2.5,2.7,2.9,3.1,3.4,3.4,3.4,3.7",rödinghausen
05758032,14768,7232,7536,05758032,8.8,5.8,3.0,2.4,4.6,1040,679,361,1298,861,437,7.0,"6.8,7.7,8.0,8.4,8.7,8.9,8.8,9.2,9.0,9.0,9.0,9.0,8.8","5.4,5.8,5.9,6.1,6.2,6.0,6.0,6.2,6.0,5.9,6.2,6.1,5.8","1.3,1.9,2.1,2.3,2.4,2.9,2.8,3.0,3.0,3.1,2.7,2.9,3.0","spenge, stadt"
05758036,18914,9447,9467,05758036,9.2,6.1,3.1,2.5,5.1,1435,970,465,1739,1161,578,7.6,"7.4,8.3,8.6,9.2,9.0,9.4,9.4,9.6,9.9,9.5,9.4,9.3,9.2","5.8,6.1,6.2,6.5,6.2,6.3,6.3,6.4,6.4,6.1,6.3,6.2,6.1","1.6,2.1,2.4,2.7,2.7,3.1,3.0,3.2,3.5,3.4,3.1,3.2,3.1","vlotho, stadt"
05762004,18699,9140,9559,05762004,10.5,7.2,3.2,3.1,7.8,2048,1465,583,1956,1352,604,11.0,"7.7,8.9,9.1,9.2,9.5,9.8,10.1,10.1,10.7,10.7,10.7,10.9,10.5","6.5,7.1,7.2,7.1,7.2,7.0,7.4,7.2,7.3,7.3,7.7,7.8,7.2","1.2,1.8,1.9,2.1,2.3,2.8,2.7,2.9,3.4,3.4,3.0,3.1,3.2","bad driburg, stadt"
05762008,13442,6641,6801,05762008,10.1,7.5,2.6,1.8,5.5,986,739,247,1360,1004,356,7.3,"8.2,9.2,9.1,9.6,9.7,9.8,9.8,9.7,10.0,10.4,10.3,10.3,10.1","6.8,7.4,7.4,7.7,7.6,7.5,7.6,7.5,7.5,7.7,7.9,7.7,7.5","1.4,1.7,1.7,1.9,2.1,2.4,2.2,2.2,2.5,2.7,2.4,2.6,2.6","beverungen, stadt"
05762012,9497,4944,4553,05762012,8.6,6.0,2.5,2.0,4.3,600,412,188,816,574,242,6.3,"7.7,8.6,8.7,9.0,9.0,9.2,9.1,9.3,9.1,9.0,9.1,8.9,8.6","6.7,7.1,7.2,7.1,7.0,7.1,7.0,7.0,6.7,6.4,6.6,6.5,6.0","1.0,1.4,1.5,1.9,2.0,2.1,2.2,2.3,2.4,2.6,2.5,2.4,2.5","borgentreich, orgelstadt"
05762016,16586,8368,8218,05762016,9.3,6.6,2.7,2.5,6.0,1416,997,419,1539,1097,442,8.5,"6.9,8.1,8.4,8.4,8.9,9.1,9.3,9.5,9.6,9.5,10.0,9.7,9.3","5.9,6.5,6.7,6.7,7.0,7.0,7.0,7.0,6.8,6.6,7.4,7.1,6.6","1.0,1.6,1.6,1.7,1.9,2.1,2.3,2.5,2.7,2.9,2.6,2.6,2.7","brakel, stadt"
05762020,29589,14691,14898,05762020,9.1,6.8,2.3,2.2,6.7,2612,1975,637,2704,2021,683,8.8,"6.9,7.7,7.9,8.1,8.5,8.7,8.9,8.8,8.9,9.3,9.2,9.5,9.1","5.8,6.2,6.3,6.4,6.7,6.7,6.7,6.7,6.7,6.8,7.0,7.2,6.8","1.1,1.5,1.6,1.7,1.8,2.0,2.2,2.1,2.2,2.5,2.2,2.4,2.3","höxter, stadt"
05762024,5125,2592,2533,05762024,9.3,6.7,2.6,2.1,5.7,402,294,108,477,344,133,7.8,"6.2,7.2,7.5,8.5,7.9,8.3,9.2,9.6,10.4,9.6,9.6,9.9,9.3","5.3,5.9,6.0,6.5,6.0,6.5,6.9,7.5,7.9,7.2,7.1,7.3,6.7","0.9,1.3,1.5,1.9,2.0,1.8,2.3,2.1,2.4,2.4,2.5,2.6,2.6","marienmünster, stadt"
05762028,6254,3231,3023,05762028,9.9,7.2,2.7,2.4,5.0,462,315,147,621,450,171,7.4,"7.7,8.6,8.9,9.6,10.0,10.4,10.2,10.5,10.8,11.1,10.3,10.5,9.9","6.3,6.7,7.0,7.5,7.5,8.1,7.7,7.9,7.8,8.1,7.7,7.7,7.2","1.4,1.9,1.9,2.1,2.5,2.2,2.5,2.6,3.0,3.0,2.7,2.8,2.7","nieheim, stadt"
05762032,12922,6446,6476,05762032,10.1,7.1,3.0,3.3,8.0,1458,1029,429,1301,919,382,11.3,"8.8,9.7,9.8,10.0,10.0,10.5,10.6,11.1,11.3,11.3,11.1,11.3,10.1","7.4,7.9,8.0,8.0,7.9,8.1,8.0,8.2,8.3,8.3,8.4,8.5,7.1","1.4,1.9,1.8,2.0,2.1,2.4,2.7,2.9,3.0,3.0,2.7,2.8,3.0","steinheim, stadt"
05762036,23629,11761,11868,05762036,9.1,6.5,2.6,2.8,7.4,2417,1760,657,2149,1545,604,10.2,"7.2,8.2,8.2,8.7,8.9,9.3,9.7,9.9,9.6,9.9,9.6,9.6,9.1","6.1,6.6,6.7,6.9,7.0,7.2,7.4,7.4,6.9,7.1,7.1,6.9,6.5","1.1,1.6,1.4,1.8,1.9,2.1,2.3,2.5,2.7,2.8,2.5,2.7,2.6","warburg, hansestadt"
05762040,8267,4192,4075,05762040,8.7,6.5,2.2,1.6,3.7,439,310,129,720,537,183,5.3,"7.2,7.8,8.0,8.0,8.3,8.3,8.6,8.5,8.6,9.1,8.8,8.8,8.7","6.2,6.4,6.7,6.6,6.8,6.6,7.0,6.6,6.5,6.9,7.1,6.7,6.5","1.0,1.4,1.4,1.5,1.6,1.7,1.6,1.9,2.1,2.3,1.7,2.1,2.2","willebadessen, stadt"
05766004,9828,5074,4754,05766004,9.0,6.0,3.0,1.4,3.5,482,341,141,883,586,297,4.9,"6.7,8.3,8.1,8.7,9.5,9.6,9.4,9.6,10.0,9.9,9.2,9.6,9.0","5.5,6.2,6.1,6.5,6.9,6.9,6.8,7.0,6.9,6.8,6.6,6.6,6.0","1.2,2.1,2.1,2.2,2.6,2.7,2.6,2.6,3.1,3.0,2.6,3.0,3.0",augustdorf
05766008,53341,25619,27722,05766008,9.7,6.7,3.0,3.1,7.0,5371,3742,1629,5152,3558,1594,10.1,"7.2,8.6,8.5,8.8,8.9,9.2,9.3,9.5,9.6,9.7,9.7,9.9,9.7","5.8,6.4,6.3,6.4,6.4,6.5,6.6,6.5,6.5,6.6,6.8,6.8,6.7","1.5,2.2,2.2,2.4,2.5,2.7,2.8,3.0,3.1,3.1,2.9,3.1,3.0","bad salzuflen, stadt"
05766012,8846,4418,4428,05766012,8.4,6.2,2.2,2.0,5.3,646,470,176,746,548,198,7.3,"6.7,7.6,7.8,8.6,8.3,8.7,8.9,8.9,9.2,9.1,8.9,8.6,8.4","5.5,6.3,6.3,6.9,6.5,6.9,6.8,6.6,6.7,6.6,6.7,6.5,6.2","1.2,1.4,1.5,1.7,1.8,1.8,2.1,2.3,2.5,2.4,2.2,2.1,2.2","barntrup, stadt"
05766016,15370,7671,7699,05766016,8.0,5.6,2.4,2.2,5.5,1198,853,345,1225,862,363,7.8,"6.2,7.1,7.1,7.0,7.3,7.6,7.8,7.9,8.2,8.2,8.1,7.9,8.0","5.0,5.5,5.2,5.2,5.2,5.3,5.5,5.4,5.5,5.5,5.7,5.6,5.6","1.2,1.6,1.8,1.8,2.2,2.2,2.2,2.5,2.7,2.7,2.4,2.3,2.4","blomberg, stadt"
05766020,74817,36141,38676,05766020,9.0,6.4,2.6,2.7,6.6,6968,4915,2053,6715,4754,1961,9.3,"6.9,7.9,8.0,8.3,8.5,8.8,8.9,8.9,9.3,9.2,8.9,9.1,9.0","5.5,6.0,5.9,6.1,6.2,6.2,6.2,6.2,6.4,6.4,6.4,6.5,6.4","1.3,1.9,2.1,2.2,2.4,2.6,2.6,2.7,2.9,2.9,2.5,2.6,2.6","detmold, stadt"
05766024,7970,4048,3922,05766024,8.2,5.6,2.6,1.8,4.7,516,375,141,654,447,207,6.5,"6.7,8.2,8.4,8.7,8.7,8.7,8.5,8.8,9.4,9.0,8.4,8.8,8.2","5.7,6.4,6.4,6.5,6.3,6.5,6.3,6.5,6.7,6.1,6.1,6.0,5.6","1.0,1.8,1.9,2.2,2.4,2.2,2.2,2.4,2.6,3.0,2.3,2.8,2.6",dörentrup
05766028,11522,5795,5727,05766028,9.5,6.8,2.7,1.9,4.8,772,557,215,1098,789,309,6.7,"7.3,8.3,8.3,8.4,8.9,9.2,9.2,9.3,9.7,9.9,10.0,10.2,9.5","6.1,6.6,6.6,6.6,6.7,6.7,6.8,6.8,6.8,7.0,7.3,7.3,6.8","1.2,1.7,1.7,1.9,2.2,2.5,2.4,2.6,2.9,3.0,2.7,2.9,2.7",extertal
05766032,17126,8324,8802,05766032,9.5,6.8,2.7,2.2,5.9,1380,1011,369,1621,1164,457,8.1,"6.5,7.5,7.8,8.2,8.3,8.3,8.5,8.7,8.9,9.3,8.9,9.2,9.5","5.3,5.8,5.8,6.2,6.2,6.2,6.3,6.3,6.3,6.5,6.6,6.8,6.8","1.2,1.7,2.0,2.0,2.1,2.1,2.2,2.4,2.6,2.7,2.3,2.5,2.7","horn-bad meinberg, stadt"
05766036,13914,6902,7012,05766036,9.1,6.5,2.6,1.8,4.3,856,601,255,1268,905,363,6.2,"6.7,7.7,7.9,8.3,8.2,8.8,8.6,9.0,9.4,9.4,9.4,9.2,9.1","5.5,6.0,6.0,6.3,6.1,6.4,6.2,6.5,6.6,6.6,6.8,6.6,6.5","1.2,1.8,1.9,2.1,2.1,2.4,2.4,2.5,2.8,2.9,2.6,2.7,2.6",kalletal
05766040,35120,17336,17784,05766040,9.8,6.9,2.9,2.0,5.1,2493,1800,693,3442,2423,1019,7.1,"7.5,8.6,9.0,9.3,9.2,9.7,9.4,9.6,9.6,9.5,9.4,9.9,9.8","6.0,6.5,6.8,7.0,6.6,6.8,6.7,6.8,6.7,6.5,6.7,7.1,6.9","1.5,2.1,2.2,2.3,2.6,2.9,2.7,2.9,2.9,3.0,2.8,2.9,2.9","lage, stadt"
05766044,41276,20457,20819,05766044,9.3,6.6,2.7,2.8,6.6,3882,2744,1138,3821,2709,1112,9.4,"7.0,8.0,8.2,8.6,8.7,8.8,9.1,9.2,9.5,9.6,9.4,9.6,9.3","5.6,6.1,6.3,6.3,6.3,6.2,6.5,6.4,6.5,6.5,6.7,6.9,6.6","1.4,1.9,2.0,2.3,2.4,2.6,2.6,2.8,3.0,3.1,2.6,2.7,2.7","lemgo, stadt"
05766048,16401,8148,8253,05766048,9.4,6.5,3.0,2.5,5.3,1286,868,418,1549,1059,490,7.8,"7.0,8.3,8.3,9.0,9.3,9.5,9.5,9.7,10.0,10.1,9.8,9.7,9.4","5.7,6.4,6.3,6.6,6.7,6.8,6.7,6.8,6.9,6.9,7.0,6.9,6.5","1.2,1.9,2.0,2.4,2.6,2.7,2.8,2.9,3.1,3.2,2.9,2.8,3.0",leopoldshöhe
05766052,9751,4851,4900,05766052,9.5,6.7,2.7,2.2,5.0,708,492,216,922,656,266,7.3,"7.2,8.2,8.4,8.8,8.5,8.9,9.3,9.1,9.3,9.5,9.6,9.7,9.5","5.9,6.5,6.5,6.8,6.5,6.7,6.8,6.6,6.4,6.5,7.0,6.9,6.7","1.2,1.7,1.9,2.0,2.0,2.2,2.5,2.5,2.8,3.0,2.6,2.8,2.7","lügde, stadt der osterräder"
05766056,17616,8722,8894,05766056,8.8,5.9,3.0,2.1,4.5,1161,795,366,1559,1034,525,6.6,"6.9,8.2,8.3,8.6,8.6,8.8,9.0,9.0,9.4,9.5,9.5,9.5,8.8","5.5,6.0,5.9,6.1,6.1,6.1,6.2,6.1,6.3,6.2,6.6,6.3,5.9","1.5,2.2,2.4,2.5,2.6,2.8,2.8,2.9,3.1,3.3,2.8,3.1,3.0","oerlinghausen, stadt"
05766060,8708,4341,4367,05766060,8.1,5.9,2.2,1.4,3.7,445,323,122,706,517,189,5.1,"6.4,7.7,7.7,8.3,8.2,8.6,9.1,9.0,9.1,8.8,8.6,8.4,8.1","5.4,6.2,6.2,6.5,6.3,6.4,6.8,6.6,6.5,6.2,6.4,6.3,5.9","0.9,1.6,1.5,1.7,1.8,2.2,2.3,2.4,2.6,2.6,2.2,2.1,2.2","schieder-schwalenberg, stadt"
05766064,9144,4643,4501,05766064,9.5,6.7,2.8,1.7,3.6,485,332,153,871,615,256,5.3,"6.7,7.8,7.5,8.6,9.0,8.7,9.2,9.5,9.7,10.1,9.8,10.1,9.5","5.3,5.9,5.9,6.3,6.4,6.3,6.5,6.8,6.7,6.9,7.4,7.3,6.7","1.4,1.9,1.7,2.3,2.6,2.4,2.7,2.7,3.1,3.2,2.4,2.8,2.8",schlangen
05770004,48990,23905,25085,05770004,8.7,5.9,2.8,3.8,7.3,5434,3588,1846,4247,2880,1367,11.1,"6.8,8.0,8.2,8.8,8.9,9.5,9.3,9.3,9.5,9.1,8.8,9.0,8.7","5.4,6.0,6.0,6.4,6.3,6.6,6.5,6.3,6.4,6.0,6.0,6.1,5.9","1.4,2.1,2.2,2.4,2.6,2.8,2.8,2.9,3.1,3.1,2.7,2.9,2.8","bad oeynhausen, stadt"
05770008,24921,12213,12708,05770008,9.1,6.0,3.2,3.8,7.7,2867,1910,957,2278,1486,792,11.5,"7.0,8.2,8.0,8.3,8.6,9.1,9.0,9.4,9.3,9.6,9.2,9.6,9.1","5.6,6.0,5.9,5.9,6.0,6.2,6.3,6.2,5.9,5.9,6.1,6.5,6.0","1.4,2.2,2.1,2.4,2.6,3.0,2.7,3.3,3.3,3.6,3.1,3.2,3.2","espelkamp, stadt"
05770012,15916,7890,8026,05770012,9.1,6.2,2.9,2.0,4.5,1032,712,320,1442,985,457,6.5,"6.5,7.8,8.0,8.1,8.0,8.2,8.1,8.6,8.7,8.8,9.0,9.0,9.1","5.5,6.2,6.1,5.9,5.7,5.6,5.7,5.8,5.9,5.9,6.1,6.0,6.2","1.0,1.6,1.9,2.2,2.3,2.5,2.5,2.7,2.9,3.0,2.9,2.9,2.9",hille
05770016,13271,6651,6620,05770016,10.0,6.4,3.6,2.8,5.6,1116,741,375,1321,847,474,8.4,"7.4,8.9,8.9,9.4,9.5,10.2,9.9,9.9,9.9,10.2,10.1,10.0,10.0","6.0,6.7,6.4,6.7,6.6,6.9,6.6,6.4,6.4,6.6,6.4,6.5,6.4","1.5,2.2,2.5,2.7,2.9,3.3,3.3,3.5,3.6,3.7,3.7,3.5,3.6",hüllhorst
05770020,25462,12270,13192,05770020,9.4,6.0,3.4,3.7,7.4,2821,1877,944,2384,1525,859,11.1,"7.1,8.4,8.5,9.1,9.1,9.2,9.4,9.5,9.5,9.8,9.5,9.7,9.4","5.6,6.2,6.1,6.3,6.3,6.3,6.4,6.5,6.4,6.4,6.4,6.4,6.0","1.5,2.1,2.4,2.7,2.8,2.9,3.0,3.0,3.1,3.4,3.0,3.3,3.4","lübbecke, stadt"
05770024,81598,40066,41532,05770024,8.5,5.9,2.5,2.6,6.1,7125,5003,2122,6902,4839,2063,8.7,"6.5,7.6,7.6,7.9,8.1,8.3,8.3,8.4,8.5,8.6,8.6,8.6,8.5","5.3,5.8,5.8,5.9,5.9,5.9,5.9,5.7,5.8,5.8,6.2,6.1,5.9","1.2,1.8,1.8,2.0,2.3,2.4,2.4,2.7,2.7,2.8,2.4,2.4,2.5","minden, stadt"
05770028,25663,12945,12718,05770028,8.9,6.3,2.6,2.0,4.5,1688,1165,523,2281,1619,662,6.6,"6.9,7.9,7.9,8.3,8.6,8.9,8.9,9.0,9.2,9.2,9.1,9.0,8.9","5.6,6.1,6.1,6.3,6.4,6.6,6.6,6.5,6.4,6.4,6.6,6.5,6.3","1.3,1.8,1.8,2.0,2.2,2.3,2.4,2.5,2.8,2.9,2.4,2.5,2.6","petershagen, stadt"
05770032,35430,17486,17944,05770032,8.5,5.7,2.8,2.1,4.7,2423,1664,759,3009,2019,990,6.8,"6.9,7.9,8.1,8.5,8.8,9.0,9.2,9.2,9.1,9.0,8.7,8.8,8.5","5.6,6.1,6.2,6.4,6.4,6.4,6.5,6.5,6.2,6.0,6.2,6.0,5.7","1.2,1.8,1.9,2.1,2.4,2.6,2.7,2.7,2.9,3.0,2.6,2.7,2.8","porta westfalica, stadt"
05770036,12647,6258,6389,05770036,10.1,6.7,3.4,2.8,5.9,1107,752,355,1279,851,428,8.8,"6.8,8.2,8.2,8.6,9.0,9.4,9.6,9.9,10.4,10.1,10.2,10.8,10.1","5.4,6.1,6.0,6.2,6.4,6.5,6.6,6.7,6.9,6.5,7.0,7.3,6.7","1.4,2.1,2.2,2.5,2.6,2.9,3.0,3.1,3.5,3.6,3.2,3.5,3.4","preußisch oldendorf, stadt"
05770040,15581,7844,7737,05770040,9.9,6.3,3.6,3.1,5.1,1283,793,490,1541,974,567,8.2,"6.7,7.8,8.1,8.4,8.9,9.0,9.1,9.2,9.8,9.8,9.9,9.7,9.9","5.4,5.9,5.9,6.1,6.4,6.1,6.3,5.9,6.1,6.0,6.4,6.3,6.3","1.2,1.9,2.2,2.3,2.5,2.9,2.9,3.3,3.7,3.7,3.4,3.4,3.6","rahden, stadt"
05770044,13571,6960,6611,05770044,10.7,7.0,3.7,3.2,5.6,1192,755,437,1451,950,501,8.8,"7.3,8.1,8.4,9.0,9.1,10.0,9.9,10.3,10.9,10.7,11.0,11.1,10.7","5.9,6.2,6.1,6.4,6.4,6.7,6.8,6.8,7.1,6.8,7.1,7.1,7.0","1.4,1.9,2.3,2.5,2.6,3.2,3.1,3.5,3.8,3.8,3.9,4.0,3.7",stemwede
05774004,9294,4707,4587,05774004,9.6,6.8,2.9,1.8,4.2,551,387,164,896,628,268,5.9,"7.3,8.5,7.9,8.6,8.9,9.6,9.7,9.9,10.0,10.0,9.4,9.3,9.6","6.0,6.7,6.2,6.5,6.6,6.9,6.9,6.9,6.8,6.8,6.8,6.7,6.8","1.3,1.8,1.7,2.1,2.3,2.7,2.8,2.9,3.2,3.2,2.6,2.7,2.9",altenbeken
05774008,15572,7576,7996,05774008,10.3,6.8,3.5,3.2,6.3,1481,976,505,1605,1054,551,9.5,"7.3,8.9,8.7,9.0,9.3,9.6,9.8,10.1,10.3,10.6,10.3,10.3,10.3","5.8,6.7,6.5,6.5,6.5,6.8,6.9,6.8,6.9,7.0,7.1,6.9,6.8","1.5,2.2,2.3,2.6,2.8,2.8,2.9,3.2,3.4,3.6,3.3,3.4,3.5","bad lippspringe, stadt"
05774012,13447,6695,6752,05774012,9.2,6.3,2.9,2.5,5.4,1058,720,338,1242,849,393,7.9,"7.5,8.3,8.4,8.4,8.7,9.0,9.2,9.2,9.6,9.7,9.5,9.7,9.2","6.1,6.4,6.0,6.1,6.1,6.2,6.5,6.5,6.6,6.4,6.7,6.8,6.3","1.5,1.9,2.4,2.3,2.6,2.8,2.7,2.7,3.0,3.2,2.8,2.9,2.9",borchen
05774016,21772,11305,10467,05774016,11.3,7.6,3.7,3.5,6.8,2251,1483,768,2459,1644,815,10.3,"8.5,9.9,10.3,10.7,10.9,11.2,11.4,11.4,11.8,11.7,11.3,11.7,11.3","7.0,7.7,8.0,8.0,8.0,8.1,8.0,7.9,8.0,8.0,8.0,8.0,7.6","1.5,2.2,2.3,2.7,2.9,3.1,3.3,3.5,3.8,3.7,3.3,3.7,3.7","büren, stadt"
05774020,31964,16316,15648,05774020,12.6,8.6,3.9,3.4,8.0,3626,2542,1084,4019,2762,1257,11.3,"9.5,10.8,11.1,11.8,12.3,12.8,12.7,13.1,13.3,13.1,13.3,13.0,12.6","7.8,8.2,8.4,8.8,9.0,9.1,9.1,9.2,9.1,8.9,9.4,9.1,8.6","1.8,2.5,2.7,2.9,3.4,3.6,3.6,3.8,4.2,4.1,3.9,3.9,3.9","delbrück, stadt"
05774024,16080,8166,7914,05774024,12.2,8.0,4.2,4.1,8.0,1948,1292,656,1961,1292,669,12.1,"9.4,10.7,11.0,11.2,11.9,12.0,11.9,11.9,11.8,11.9,12.1,12.3,12.2","7.5,7.9,8.1,8.1,8.5,8.4,8.4,8.2,7.9,7.9,8.3,8.3,8.0","2.0,2.8,2.8,3.1,3.4,3.6,3.5,3.7,3.8,4.1,3.9,4.0,4.2","hövelhof, sennegemeinde"
05774028,10589,5449,5140,05774028,10.0,6.9,3.1,2.4,4.6,739,489,250,1062,735,327,7.0,"6.7,8.1,8.5,8.8,8.9,9.4,9.2,9.3,9.4,10.0,9.7,9.9,10.0","5.7,6.4,6.7,6.9,6.8,6.8,6.8,6.8,6.7,6.9,7.1,7.2,6.9","1.1,1.6,1.8,1.9,2.1,2.5,2.4,2.4,2.7,3.1,2.6,2.8,3.1","lichtenau, stadt"
05774032,148126,73680,74446,05774032,10.5,7.4,3.0,3.5,8.8,18267,13077,5190,15528,11030,4498,12.3,"7.7,9.0,9.2,9.6,9.7,10.1,10.3,10.5,10.8,11.1,10.8,10.8,10.5","6.1,6.7,6.9,7.1,7.0,7.0,7.1,7.1,7.3,7.5,7.9,7.8,7.4","1.7,2.3,2.3,2.5,2.7,3.1,3.2,3.3,3.5,3.6,2.9,3.0,3.0","paderborn, stadt"
05774036,25186,12493,12693,05774036,10.2,7.2,3.0,2.7,6.8,2394,1718,676,2568,1820,748,9.5,"8.2,9.1,9.5,9.6,9.9,10.1,10.4,10.5,10.8,10.8,10.8,10.8,10.2","6.6,6.8,7.2,7.1,7.2,7.3,7.5,7.3,7.4,7.4,7.8,7.6,7.2","1.6,2.2,2.2,2.5,2.7,2.8,2.9,3.2,3.4,3.5,3.0,3.1,3.0","salzkotten, stadt"
05774040,12302,6162,6140,05774040,11.7,8.2,3.5,3.3,7.3,1303,899,404,1437,1009,428,10.6,"8.9,9.6,10.1,10.8,11.0,11.3,10.8,11.7,11.9,12.0,12.0,11.9,11.7","7.4,7.5,7.9,8.4,8.3,8.4,7.8,8.4,8.5,8.3,8.7,8.4,8.2","1.5,2.1,2.2,2.3,2.6,2.9,3.0,3.3,3.4,3.7,3.3,3.5,3.5","bad wünnenberg, stadt"
05911000,364742,177427,187315,05911000,8.8,6.6,2.2,2.4,6.9,33870,25088,8782,32256,24052,8204,9.3,"6.5,7.7,7.7,8.2,8.4,8.6,8.8,8.9,9.0,9.2,9.1,9.2,8.8","5.3,6.0,6.0,6.2,6.4,6.4,6.5,6.5,6.6,6.6,6.9,6.9,6.6","1.1,1.7,1.8,1.9,2.0,2.2,2.3,2.4,2.5,2.6,2.1,2.2,2.2","bochum, stadt"
05913000,586181,287846,298335,05913000,8.5,6.4,2.2,2.5,6.6,53554,38838,14716,49951,37260,12691,9.1,"6.4,7.7,7.7,8.1,8.2,8.4,8.5,8.5,8.7,8.9,8.7,8.7,8.5","5.4,6.0,6.0,6.2,6.2,6.2,6.3,6.2,6.3,6.3,6.6,6.6,6.4","1.0,1.6,1.7,1.8,2.0,2.2,2.3,2.3,2.4,2.5,2.1,2.1,2.2","dortmund, stadt"
05914000,189044,92207,96837,05914000,9.6,6.9,2.7,2.8,6.8,18203,12840,5363,18085,12968,5117,9.6,"7.2,8.5,8.5,8.8,9.1,9.3,9.3,9.6,9.7,9.7,9.7,9.7,9.6","5.9,6.5,6.4,6.6,6.6,6.7,6.6,6.8,6.7,6.7,7.0,7.0,6.9","1.3,1.9,2.1,2.2,2.4,2.6,2.7,2.8,2.9,3.0,2.7,2.7,2.7","hagen, stadt der fernuniversität"
05915000,179397,88166,91231,05915000,9.5,7.1,2.4,2.4,6.8,16532,12237,4295,16974,12657,4317,9.2,"7.2,8.3,8.4,8.7,8.8,9.2,9.4,9.5,9.6,9.9,9.9,9.9,9.5","6.1,6.7,6.7,6.9,6.8,6.9,7.0,7.0,7.1,7.2,7.5,7.5,7.1","1.1,1.6,1.7,1.8,2.0,2.3,2.3,2.5,2.5,2.7,2.4,2.4,2.4","hamm, stadt"
05916000,155851,75940,79911,05916000,8.2,6.2,2.0,1.5,5.0,10244,7831,2413,12785,9709,3076,6.6,"6.6,7.6,7.4,7.6,7.9,8.1,8.3,8.5,8.3,8.7,8.4,8.4,8.2","5.6,6.1,5.9,6.0,6.1,6.2,6.2,6.4,6.2,6.5,6.6,6.5,6.2","1.0,1.4,1.5,1.6,1.7,1.9,2.0,2.1,2.1,2.2,1.8,1.9,2.0","herne, stadt"
05954004,9004,4442,4562,05954004,8.2,5.7,2.5,2.0,4.3,572,388,184,738,512,226,6.4,"6.2,7.3,7.4,8.0,8.1,8.4,8.3,8.7,8.7,8.8,8.6,8.9,8.2","5.0,5.4,5.4,5.8,5.8,5.9,5.8,6.2,6.0,5.9,6.1,6.3,5.7","1.2,1.9,2.0,2.2,2.3,2.5,2.5,2.5,2.8,3.0,2.5,2.6,2.5","breckerfeld, hansestadt"
05954008,29926,14635,15291,05954008,9.3,6.2,3.1,2.9,5.5,2532,1660,872,2798,1869,929,8.5,"7.2,8.4,8.4,8.8,9.4,9.7,9.7,9.8,10.0,9.8,9.7,9.7,9.3","5.9,6.3,6.3,6.3,6.7,6.7,6.8,6.7,6.8,6.5,6.8,6.7,6.2","1.4,2.1,2.2,2.5,2.7,2.9,2.9,3.1,3.2,3.3,3.0,3.1,3.1","ennepetal, stadt der kluterthöhle"
05954012,31315,15290,16025,05954012,9.9,6.9,3.1,2.6,6.1,2701,1900,801,3103,2147,956,8.6,"7.3,8.6,8.9,9.3,9.7,10.0,9.9,10.0,10.1,10.2,10.3,10.3,9.9","6.0,6.6,6.8,6.9,6.9,7.1,7.1,7.0,7.0,6.9,7.2,7.2,6.9","1.3,2.0,2.2,2.4,2.7,2.9,2.9,3.0,3.1,3.3,3.1,3.1,3.1","gevelsberg, stadt"
05954016,54834,26608,28226,05954016,9.4,6.7,2.7,2.4,5.6,4414,3074,1340,5130,3661,1469,8.0,"7.2,8.5,8.7,8.9,9.3,9.5,9.6,9.7,9.9,10.0,9.8,9.7,9.4","6.1,6.6,6.6,6.7,6.8,6.8,6.8,6.9,7.0,7.0,7.2,7.0,6.7","1.1,1.9,2.1,2.2,2.5,2.7,2.8,2.8,2.9,3.0,2.6,2.7,2.7","hattingen, stadt"
05954020,22818,10869,11949,05954020,8.8,6.1,2.7,2.6,6.8,2150,1546,604,2007,1390,617,9.4,"6.6,7.3,7.6,8.2,8.2,8.6,8.5,8.7,8.9,9.4,9.3,9.3,8.8","5.4,5.6,5.7,6.0,6.1,6.1,6.2,6.3,6.4,6.5,6.6,6.6,6.1","1.2,1.7,1.9,2.2,2.2,2.4,2.3,2.4,2.5,2.9,2.7,2.7,2.7","herdecke, stadt"
05954024,28330,13598,14732,05954024,8.9,6.2,2.7,2.8,5.3,2273,1490,783,2517,1748,769,8.0,"6.9,8.2,8.2,8.6,9.1,9.3,9.0,9.1,9.1,9.3,9.2,8.9,8.9","5.4,6.0,6.0,6.2,6.4,6.4,6.3,6.3,6.1,6.4,6.5,6.3,6.2","1.4,2.2,2.2,2.4,2.7,2.9,2.7,2.8,3.0,2.9,2.7,2.7,2.7","schwelm, stadt"
05954028,25205,12161,13044,05954028,9.0,6.2,2.8,2.3,5.8,2039,1457,582,2261,1553,708,8.1,"6.5,7.9,8.3,8.4,8.9,9.2,9.4,9.6,9.6,9.7,9.3,9.2,9.0","5.2,6.0,6.2,6.2,6.4,6.5,6.5,6.7,6.6,6.5,6.4,6.3,6.2","1.3,1.9,2.1,2.3,2.5,2.7,2.8,2.9,3.0,3.2,2.9,2.9,2.8","sprockhövel, stadt"
05954032,27822,13712,14110,05954032,8.2,5.7,2.4,2.0,4.8,1889,1325,564,2274,1597,677,6.8,"5.9,7.2,7.6,7.9,8.1,8.4,8.4,8.7,8.7,8.9,8.7,8.7,8.2","4.8,5.4,5.7,5.7,5.8,5.8,5.9,6.2,6.1,6.1,6.3,6.3,5.7","1.1,1.8,2.0,2.2,2.3,2.5,2.4,2.5,2.7,2.8,2.4,2.5,2.4","wetter (ruhr), stadt"
05954036,96700,46997,49703,05954036,9.0,6.6,2.4,2.4,6.2,8317,6009,2308,8751,6383,2368,8.6,"7.0,8.3,8.3,8.8,9.2,9.2,9.4,9.3,9.2,9.4,9.3,9.4,9.0","5.8,6.4,6.4,6.7,6.9,6.8,6.9,6.7,6.6,6.7,6.9,7.0,6.6","1.2,1.9,1.9,2.1,2.2,2.4,2.4,2.5,2.7,2.7,2.4,2.4,2.4","witten, stadt"
05958004,73784,36277,37507,05958004,11.4,7.8,3.7,4.3,10.0,10518,7352,3166,8435,5727,2708,14.3,"9.3,10.7,10.5,10.8,11.6,12.0,12.0,12.0,12.2,12.0,11.9,11.9,11.4","7.7,8.3,8.0,8.1,8.5,8.5,8.5,8.5,8.4,8.3,8.3,8.2,7.8","1.6,2.4,2.5,2.7,3.1,3.5,3.5,3.5,3.8,3.7,3.6,3.7,3.7","arnsberg, stadt"
05958008,11170,5646,5524,05958008,13.0,8.6,4.5,3.6,8.9,1395,990,405,1457,957,500,12.5,"9.5,11.0,10.8,11.3,11.9,12.9,12.8,13.1,13.3,12.9,13.1,13.4,13.0","7.5,8.1,7.8,7.9,8.0,8.8,8.7,8.7,8.9,8.7,8.9,9.1,8.6","2.0,2.8,3.0,3.4,3.8,4.1,4.1,4.3,4.4,4.1,4.2,4.3,4.5",bestwig
05958012,26232,13070,13162,05958012,12.2,8.2,4.1,3.8,7.7,3017,2009,1008,3209,2144,1065,11.5,"9.1,10.2,10.4,11.0,11.3,11.9,12.1,12.3,12.4,12.4,12.6,12.8,12.2","7.6,7.9,7.9,8.4,8.4,8.5,8.6,8.6,8.4,8.3,8.7,8.7,8.2","1.5,2.3,2.5,2.7,2.9,3.4,3.5,3.7,3.9,4.1,4.0,4.1,4.1","brilon, stadt"
05958016,8942,4554,4388,05958016,12.5,8.9,3.5,3.2,8.3,1032,743,289,1115,800,315,11.5,"8.4,9.7,10.1,10.4,11.3,11.9,11.4,11.7,11.9,12.4,12.6,12.8,12.5","7.0,7.7,7.9,8.2,8.6,8.7,8.4,8.4,8.4,8.5,8.9,9.3,8.9","1.4,2.0,2.2,2.2,2.7,3.2,3.0,3.3,3.6,3.9,3.7,3.5,3.5",eslohe (sauerland)
05958020,4541,2309,2232,05958020,11.8,8.7,3.1,2.5,5.9,382,269,113,536,396,140,8.4,"9.1,10.2,10.6,10.9,11.5,11.4,12.2,12.4,12.4,12.1,12.4,12.3,11.8","7.8,8.4,8.8,8.8,8.8,8.7,9.2,9.0,9.0,8.4,9.0,9.0,8.7","1.3,1.8,1.8,2.1,2.7,2.8,3.0,3.4,3.4,3.7,3.4,3.3,3.1","hallenberg, stadt"
05958024,19968,10182,9786,05958024,9.6,6.7,2.9,2.2,5.8,1608,1162,446,1921,1334,587,8.1,"7.1,8.3,8.2,8.5,8.7,9.5,9.4,9.6,9.6,9.9,9.8,9.7,9.6","6.2,6.7,6.5,6.6,6.5,6.9,6.8,7.0,6.8,6.9,7.1,7.0,6.7","0.9,1.6,1.7,1.8,2.2,2.7,2.5,2.6,2.7,3.0,2.7,2.7,2.9","marsberg, stadt"
05958028,7938,4008,3930,05958028,13.5,9.3,4.2,4.5,8.3,1020,661,359,1071,735,336,12.8,"8.9,10.6,10.6,10.8,11.8,12.7,12.7,13.2,13.8,13.9,14.1,13.8,13.5","7.5,8.5,8.3,8.5,9.0,9.3,9.4,9.4,9.3,9.2,9.9,9.6,9.3","1.4,2.1,2.3,2.3,2.8,3.5,3.3,3.7,4.5,4.7,4.1,4.2,4.2","medebach, hansestadt"
05958032,30119,14916,15203,05958032,11.5,8.1,3.4,3.6,8.2,3559,2480,1079,3478,2444,1034,11.8,"8.3,9.5,9.9,10.0,10.6,10.8,10.7,11.2,11.3,11.6,11.7,11.7,11.5","6.9,7.5,7.6,7.6,7.9,7.9,7.9,8.2,8.1,8.1,8.4,8.3,8.1","1.5,2.0,2.3,2.4,2.7,2.9,2.8,3.0,3.2,3.5,3.3,3.4,3.4","meschede, kreis- und  hochschulstadt"
05958036,14874,7389,7485,05958036,12.2,7.9,4.3,3.7,8.4,1806,1250,556,1820,1176,644,12.1,"8.8,10.2,10.6,11.1,11.7,12.3,13.0,12.6,12.8,12.6,12.7,12.8,12.2","7.3,7.9,8.1,8.1,8.3,8.8,8.9,8.4,8.5,8.0,8.8,8.2,7.9","1.5,2.3,2.5,3.0,3.4,3.5,4.0,4.3,4.3,4.6,3.9,4.5,4.3","olsberg, stadt"
05958040,25230,12826,12404,05958040,13.4,8.9,4.5,4.2,8.2,3130,2066,1064,3382,2241,1141,12.4,"9.3,11.0,11.4,11.5,12.0,12.5,12.9,13.1,13.2,13.1,13.6,13.6,13.4","7.7,8.6,8.5,8.6,8.7,9.0,9.1,8.9,8.9,8.7,9.4,9.2,8.9","1.6,2.5,2.9,2.9,3.3,3.6,3.8,4.1,4.3,4.4,4.2,4.4,4.5","schmallenberg, stadt"
05958044,28166,14153,14013,05958044,13.1,8.8,4.3,3.9,7.7,3269,2171,1098,3693,2488,1205,11.6,"10.3,11.8,12.1,12.5,13.1,13.1,12.9,13.6,13.7,13.6,13.4,13.5,13.1","8.7,9.3,9.3,9.2,9.6,9.4,9.1,9.6,9.3,9.2,9.3,9.3,8.8","1.6,2.5,2.8,3.2,3.6,3.8,3.8,4.0,4.4,4.4,4.1,4.2,4.3","sundern (sauerland), stadt"
05958048,12798,6434,6364,05958048,15.5,9.8,5.7,6.2,10.6,2144,1356,788,1985,1256,729,16.8,"9.8,11.5,11.3,12.2,12.7,13.6,14.1,14.6,14.8,15.4,15.7,15.4,15.5","8.1,8.9,8.4,8.7,9.1,9.4,9.8,10.0,9.8,9.8,10.3,10.1,9.8","1.7,2.6,2.9,3.5,3.6,4.1,4.3,4.6,5.0,5.6,5.4,5.3,5.7","winterberg, stadt"
05962004,17375,8592,8783,05962004,9.2,6.4,2.8,1.9,4.6,1143,807,336,1604,1109,495,6.6,"7.0,8.0,8.2,8.7,8.9,9.2,9.0,9.2,9.3,9.3,9.2,9.3,9.2","5.8,6.1,6.3,6.5,6.4,6.6,6.5,6.5,6.3,6.3,6.4,6.3,6.4","1.2,1.9,1.9,2.2,2.5,2.6,2.4,2.7,3.0,3.0,2.7,2.9,2.8","altena, stadt"
05962008,11602,5745,5857,05962008,12.4,9.0,3.5,2.8,7.6,1205,877,328,1444,1043,401,10.4,"10.1,11.9,12.1,12.9,12.9,13.1,13.0,13.0,13.2,12.9,12.7,13.3,12.4","8.6,9.1,9.3,9.6,9.5,9.6,9.8,9.4,9.5,9.2,9.4,9.5,9.0","1.5,2.8,2.8,3.3,3.4,3.5,3.2,3.5,3.7,3.8,3.3,3.8,3.5","balve, stadt"
05962012,16117,7886,8231,05962012,9.4,6.0,3.4,3.2,6.6,1570,1060,510,1514,970,544,9.7,"7.8,9.1,9.6,9.6,10.0,10.3,9.6,9.8,10.1,10.1,9.8,9.5,9.4","6.1,6.7,6.9,6.7,6.8,6.7,6.7,6.8,6.7,6.8,6.6,6.2,6.0","1.6,2.5,2.7,3.0,3.2,3.6,3.0,3.0,3.4,3.3,3.3,3.3,3.4","halver, stadt"
05962016,33535,16498,17037,05962016,10.9,7.7,3.2,3.0,6.8,3261,2266,995,3660,2584,1076,9.7,"7.9,9.2,9.2,9.8,10.2,10.6,10.3,10.7,10.5,10.7,10.8,11.3,10.9","6.5,7.1,7.0,7.3,7.4,7.5,7.5,7.6,7.4,7.4,7.8,8.0,7.7","1.4,2.1,2.2,2.5,2.8,3.1,2.8,3.1,3.1,3.3,3.1,3.3,3.2","hemer, stadt"
05962020,7217,3577,3640,05962020,9.1,5.6,3.5,2.4,4.5,503,328,175,658,405,253,7.0,"7.4,8.9,9.2,9.2,9.6,10.1,9.3,9.6,10.2,9.5,9.7,9.5,9.1","5.6,6.1,6.1,6.0,6.2,6.5,6.2,5.9,6.6,6.3,6.5,6.3,5.6","1.7,2.8,3.1,3.3,3.4,3.6,3.1,3.7,3.5,3.2,3.2,3.2,3.5",herscheid
05962024,93537,45770,47767,05962024,10.0,7.1,2.9,3.2,7.6,10098,7134,2964,9372,6617,2755,10.8,"8.1,9.4,9.5,10.1,10.1,10.5,10.1,10.3,10.4,10.3,10.3,10.4,10.0","6.7,7.3,7.2,7.5,7.4,7.6,7.4,7.3,7.3,7.2,7.4,7.4,7.1","1.4,2.1,2.3,2.6,2.7,2.9,2.7,3.0,3.1,3.2,2.9,3.0,2.9","iserlohn, stadt"
05962028,16300,8060,8240,05962028,10.6,7.3,3.2,2.2,5.5,1256,901,355,1722,1193,529,7.7,"7.7,8.6,8.9,9.2,9.7,9.6,9.0,9.8,10.2,10.4,10.5,10.8,10.6","6.2,6.4,6.7,6.6,6.9,6.7,6.5,7.0,7.2,7.2,7.5,7.7,7.3","1.5,2.2,2.3,2.6,2.8,2.9,2.6,2.8,3.1,3.2,3.0,3.1,3.2","kierspe, stadt"
05962032,73354,35955,37399,05962032,9.0,5.6,3.4,3.6,7.0,7831,5171,2660,6583,4113,2470,10.7,"7.3,8.5,8.5,8.7,9.1,9.2,9.0,9.2,9.4,9.6,9.3,9.2,9.0","5.6,5.9,5.9,5.9,6.0,5.9,6.0,6.0,5.8,5.8,6.0,5.9,5.6","1.7,2.5,2.6,2.8,3.1,3.2,3.1,3.3,3.6,3.8,3.3,3.4,3.4","lüdenscheid, stadt"
05962036,20670,10359,10311,05962036,10.1,7.1,3.0,3.3,6.3,1998,1312,686,2078,1460,618,9.7,"8.7,10.0,9.8,10.1,10.4,10.8,10.2,10.6,10.6,10.4,10.1,10.4,10.1","7.0,7.6,7.4,7.6,7.7,7.9,7.5,7.7,7.3,7.0,7.2,7.2,7.1","1.7,2.4,2.4,2.5,2.7,3.0,2.7,2.9,3.2,3.4,2.9,3.2,3.0","meinerzhagen, stadt"
05962040,53485,26238,27247,05962040,10.4,7.4,3.0,2.5,6.6,4887,3553,1334,5580,3977,1603,9.1,"9.0,10.1,10.3,10.8,10.9,11.2,11.2,11.6,11.5,11.4,11.2,11.1,10.4","7.7,8.1,8.1,8.3,8.2,8.2,8.2,8.4,8.1,8.0,8.2,8.1,7.4","1.3,2.0,2.2,2.5,2.7,3.0,3.0,3.2,3.3,3.5,3.0,3.0,3.0","menden (sauerland), stadt"
05962044,6644,3332,3312,05962044,8.8,6.4,2.5,1.2,3.3,300,220,80,586,422,164,4.5,"6.6,8.1,8.2,8.8,9.4,10.0,9.1,9.1,9.5,9.2,9.1,9.0,8.8","5.6,6.4,6.5,6.8,6.8,7.4,6.7,6.5,6.9,6.4,6.8,6.6,6.4","0.9,1.7,1.7,2.0,2.6,2.6,2.3,2.6,2.6,2.8,2.3,2.5,2.5",nachrodt-wiblingwerde
05962048,12024,5991,6033,05962048,10.3,7.0,3.3,2.7,6.5,1111,787,324,1235,840,395,9.2,"8.3,9.8,9.7,10.4,10.6,11.0,10.7,11.2,10.9,11.0,10.8,10.6,10.3","6.8,7.6,7.5,7.8,7.7,7.9,7.9,7.9,7.6,7.7,7.8,7.3,7.0","1.5,2.3,2.2,2.6,2.9,3.0,2.8,3.3,3.4,3.3,3.1,3.3,3.3","neuenrade, stadt"
05962052,25781,12851,12930,05962052,10.1,6.9,3.2,3.1,6.3,2432,1621,811,2603,1785,818,9.4,"8.8,10.1,10.1,10.8,10.8,11.1,10.0,10.8,10.9,10.8,10.6,10.6,10.1","7.0,7.4,7.4,7.7,7.4,7.7,7.2,7.4,7.4,7.2,7.6,7.4,6.9","1.9,2.6,2.6,3.0,3.4,3.4,2.9,3.4,3.6,3.6,3.1,3.2,3.2","plettenberg, stadt"
05962056,10528,5194,5334,05962056,9.6,6.1,3.5,2.9,5.0,832,527,305,1011,638,373,7.9,"8.2,9.2,9.5,9.3,9.8,9.5,9.2,10.0,10.1,9.8,9.8,10.0,9.6","6.6,6.8,6.7,6.4,6.7,6.2,6.1,6.6,6.4,6.0,6.4,6.2,6.1","1.6,2.4,2.8,2.9,3.1,3.2,3.2,3.4,3.7,3.8,3.3,3.8,3.5",schalksmühle
05962060,18002,8939,9063,05962060,9.2,6.6,2.6,2.1,5.3,1333,955,378,1656,1191,465,7.4,"7.4,8.3,8.7,9.3,9.3,9.8,9.1,9.4,9.4,9.4,9.5,9.4,9.2","5.8,6.1,6.3,6.7,6.4,6.8,6.6,6.6,6.4,6.5,6.8,6.8,6.6","1.5,2.2,2.3,2.6,2.8,3.0,2.5,2.8,3.0,2.9,2.7,2.6,2.6","werdohl, stadt"
05966004,24676,12499,12177,05966004,11.0,7.5,3.6,3.4,7.1,2585,1746,839,2722,1843,879,10.5,"9.2,10.6,10.6,10.7,11.1,11.4,11.0,11.3,11.4,11.3,11.6,11.5,11.0","7.5,7.9,7.8,7.9,7.9,8.0,7.7,7.9,7.8,7.7,8.2,8.0,7.5","1.8,2.7,2.8,2.9,3.1,3.4,3.3,3.4,3.7,3.6,3.4,3.5,3.6","attendorn, hansestadt"
05966008,11874,6003,5871,05966008,12.0,8.1,3.9,3.1,5.8,1058,685,373,1429,960,469,8.9,"9.2,10.6,10.6,10.9,11.3,11.8,11.4,12.1,11.8,12.3,13.0,12.8,12.0","7.3,7.7,7.7,7.6,7.9,8.1,7.9,8.4,7.9,8.4,8.8,8.6,8.1","1.9,2.9,2.9,3.3,3.4,3.7,3.5,3.7,4.0,3.9,4.2,4.1,3.9","drolshagen, stadt"
05966012,17258,8849,8409,05966012,12.7,8.6,4.1,2.8,6.3,1573,1082,491,2193,1480,713,9.1,"9.7,11.6,11.6,12.0,12.5,12.8,12.0,12.9,13.1,13.2,13.6,13.2,12.7","8.0,8.8,8.9,8.9,9.2,9.3,8.7,9.1,9.0,9.1,9.6,9.1,8.6","1.7,2.9,2.7,3.1,3.4,3.5,3.3,3.8,4.0,4.1,4.1,4.2,4.1",finnentrop
05966016,11854,6016,5838,05966016,12.8,8.5,4.3,3.9,7.4,1342,876,466,1522,1007,515,11.3,"8.2,10.0,10.0,10.8,10.8,11.4,11.9,12.4,12.5,12.6,12.5,12.8,12.8","6.9,7.7,7.7,8.0,7.8,8.1,8.3,8.7,8.4,8.5,8.6,8.6,8.5","1.3,2.3,2.4,2.8,3.0,3.4,3.6,3.7,4.1,4.1,3.9,4.2,4.3",kirchhundem
05966020,26073,13154,12919,05966020,13.0,9.0,4.0,4.2,9.3,3535,2431,1104,3390,2338,1052,13.6,"9.4,11.0,11.1,11.6,12.2,12.4,12.2,12.4,12.5,12.9,13.4,13.3,13.0","8.0,8.7,8.7,8.9,9.0,9.0,8.9,9.0,8.8,8.9,9.4,9.2,9.0","1.4,2.3,2.4,2.7,3.2,3.4,3.3,3.4,3.7,4.1,4.0,4.1,4.0","lennestadt, stadt"
05966024,24757,12107,12650,05966024,11.8,7.6,4.2,4.7,9.8,3609,2436,1173,2913,1875,1038,14.6,"8.6,10.1,10.3,10.7,10.8,11.3,11.2,11.5,11.5,11.8,12.1,12.0,11.8","6.9,7.5,7.5,7.6,7.5,7.7,7.8,7.7,7.5,7.7,8.2,8.0,7.6","1.8,2.7,2.8,3.1,3.3,3.6,3.4,3.8,4.0,4.1,3.9,4.0,4.2","olpe, stadt"
05966028,19873,9996,9877,05966028,12.5,8.4,4.1,3.4,6.8,2033,1360,673,2494,1677,817,10.2,"10.1,11.4,11.8,12.1,12.3,12.6,12.6,12.7,12.7,12.8,12.7,12.7,12.5","8.2,8.5,8.8,8.9,8.7,8.7,8.7,8.9,8.6,8.8,8.9,8.7,8.4","1.9,2.9,3.0,3.1,3.6,3.9,3.9,3.8,4.1,4.1,3.8,4.0,4.1",wenden
05970004,19774,10017,9757,05970004,10.6,6.9,3.7,3.5,6.7,2003,1315,688,2099,1362,737,10.1,"8.5,9.7,9.9,10.6,10.8,11.4,11.2,11.2,11.8,11.6,11.7,11.0,10.6","6.7,7.1,7.1,7.5,7.5,7.7,7.5,7.3,7.5,7.2,7.6,7.1,6.9","1.9,2.6,2.9,3.1,3.3,3.7,3.7,3.9,4.3,4.5,4.0,3.9,3.7","bad berleburg, stadt"
05970008,14969,7758,7211,05970008,11.8,7.8,4.0,3.5,6.7,1536,1008,528,1771,1173,598,10.3,"9.8,10.8,10.6,11.2,11.8,12.2,11.5,11.7,12.3,12.1,11.9,12.1,11.8","8.1,8.4,8.1,8.4,8.5,8.6,8.1,8.1,8.3,8.0,8.2,8.1,7.8","1.7,2.4,2.5,2.7,3.2,3.5,3.3,3.6,4.0,4.0,3.7,3.9,4.0",burbach
05970012,7206,3671,3535,05970012,11.7,8.0,3.7,3.0,6.6,687,474,213,843,575,268,9.5,"9.5,11.0,11.2,11.8,12.2,12.6,12.5,12.6,12.8,12.5,12.0,12.3,11.7","7.9,8.7,8.6,8.8,9.2,9.3,8.9,8.9,8.8,8.6,8.4,8.7,8.0","1.6,2.3,2.6,3.1,3.0,3.4,3.7,3.7,4.0,3.9,3.7,3.7,3.7",erndtebrück
05970016,17929,8935,8994,05970016,11.1,7.8,3.3,2.8,6.3,1640,1134,506,1993,1398,595,9.1,"8.6,9.7,9.7,10.5,11.0,11.2,11.2,11.0,11.3,11.5,11.6,11.3,11.1","7.3,7.5,7.4,7.9,8.0,7.9,7.9,7.8,7.8,7.8,8.2,7.9,7.8","1.3,2.1,2.3,2.6,3.0,3.3,3.3,3.2,3.4,3.7,3.4,3.4,3.3","freudenberg, stadt"
05970020,15169,7537,7632,05970020,10.3,7.3,2.9,2.2,4.7,1037,708,329,1556,1112,444,6.8,"8.1,9.0,8.9,9.5,9.7,10.3,10.2,10.2,10.7,11.2,10.9,10.9,10.3","6.7,7.0,6.7,7.0,7.1,7.4,7.2,7.3,7.4,7.8,7.9,7.8,7.3","1.4,2.0,2.2,2.5,2.6,2.9,2.9,2.9,3.2,3.4,2.9,3.1,2.9","hilchenbach, stadt"
05970024,31500,15642,15858,05970024,10.4,7.5,2.9,2.5,6.3,2771,1994,777,3263,2348,915,8.8,"7.8,8.9,9.0,9.3,9.8,10.1,10.1,10.1,10.4,10.4,10.7,10.5,10.4","6.5,6.8,6.8,6.9,7.0,7.1,7.2,7.2,7.1,7.1,7.7,7.6,7.5","1.3,2.0,2.2,2.4,2.8,2.9,2.9,2.9,3.2,3.4,3.1,2.9,2.9","kreuztal, stadt"
05970028,14276,7261,7015,05970028,10.7,7.6,3.1,2.2,5.7,1127,808,319,1523,1080,443,7.9,"8.1,9.2,9.4,9.9,10.6,10.9,11.1,11.1,11.1,11.4,11.5,11.6,10.7","6.9,7.5,7.2,7.7,8.3,8.3,8.5,8.4,8.2,8.1,8.3,8.2,7.6","1.2,1.7,2.1,2.2,2.3,2.6,2.6,2.8,2.9,3.3,3.2,3.3,3.1","bad laasphe, stadt"
05970032,23393,11720,11673,05970032,11.6,8.0,3.6,2.5,6.7,2146,1565,581,2707,1875,832,9.2,"8.2,10.0,10.3,10.7,11.2,11.7,11.8,11.7,11.8,12.3,12.1,12.0,11.6","6.9,7.7,7.8,8.0,8.2,8.3,8.5,8.3,8.3,8.4,8.6,8.5,8.0","1.4,2.3,2.5,2.7,3.0,3.4,3.3,3.5,3.6,3.9,3.5,3.5,3.6","netphen, stadt"
05970036,13717,6954,6763,05970036,11.7,8.2,3.5,2.7,6.7,1291,921,370,1609,1130,479,9.4,"9.6,11.1,10.7,11.4,11.7,11.6,11.3,11.7,12.3,11.9,12.5,12.3,11.7","8.0,8.4,8.1,8.5,8.6,8.4,8.3,8.5,8.8,8.3,8.9,8.7,8.2","1.7,2.7,2.6,2.9,3.1,3.2,3.0,3.1,3.5,3.6,3.6,3.6,3.5",neunkirchen
05970040,102355,49925,52430,05970040,11.8,8.5,3.3,4.5,10.8,15626,11006,4620,12104,8705,3399,15.3,"8.3,9.5,9.7,10.3,10.6,10.9,11.1,11.0,11.4,11.8,11.8,11.9,11.8","6.7,7.3,7.3,7.6,7.6,7.6,7.8,7.7,7.7,8.0,8.6,8.6,8.5","1.5,2.2,2.4,2.7,2.9,3.2,3.4,3.4,3.6,3.8,3.2,3.3,3.3","siegen, universitätsstadt"
05970044,20512,10206,10306,05970044,12.3,8.5,3.8,3.4,6.9,2117,1423,694,2522,1750,772,10.3,"8.6,9.9,10.2,11.1,11.5,12.0,12.0,12.0,12.5,12.5,12.4,12.7,12.3","7.1,7.7,7.6,8.2,8.3,8.5,8.5,8.5,8.7,8.6,8.9,8.9,8.5","1.5,2.2,2.6,2.9,3.2,3.5,3.5,3.6,3.8,3.9,3.5,3.8,3.8",wilnsdorf
05974004,10557,5361,5196,05974004,12.9,8.6,4.2,3.9,8.8,1346,930,416,1357,911,446,12.7,"9.5,10.8,10.8,11.4,11.8,12.2,12.2,12.3,12.7,13.1,12.6,13.3,12.9","7.8,8.5,8.3,8.6,8.9,8.5,8.5,8.8,8.9,8.9,8.8,9.2,8.6","1.7,2.3,2.4,2.8,2.9,3.7,3.7,3.5,3.8,4.2,3.8,4.1,4.2",anröchte
05974008,11931,5735,6196,05974008,9.6,6.9,2.7,2.8,6.6,1118,784,334,1147,819,328,9.4,"7.3,8.9,9.1,9.3,9.8,9.8,9.9,10.1,10.2,10.4,10.4,10.2,9.6","6.0,7.0,7.2,7.1,7.2,7.1,7.2,7.5,7.4,7.4,7.6,7.1,6.9","1.3,1.8,1.9,2.2,2.6,2.6,2.7,2.7,2.9,3.1,2.8,3.0,2.7",bad sassendorf
05974012,12442,6269,6173,05974012,12.0,8.0,4.0,3.1,5.6,1081,692,389,1494,993,501,8.7,"9.5,10.6,10.5,11.6,12.0,12.5,12.4,12.6,12.4,13.0,13.1,12.7,12.0","7.7,7.9,7.9,8.4,8.7,8.9,8.9,8.7,8.4,8.8,9.0,8.6,8.0","1.8,2.7,2.6,3.1,3.3,3.5,3.5,3.9,4.0,4.2,4.0,4.0,4.0",ense
05974016,16128,7968,8160,05974016,11.0,7.4,3.5,2.4,6.1,1373,988,385,1771,1200,571,8.5,"8.9,10.4,10.4,10.7,11.2,11.1,11.1,10.6,11.1,11.3,11.1,11.5,11.0","7.4,8.2,8.1,8.2,8.3,8.0,8.1,7.7,7.8,7.7,7.9,8.0,7.4","1.4,2.2,2.4,2.5,2.9,3.1,3.0,2.9,3.3,3.6,3.2,3.5,3.5","erwitte, stadt"
05974020,21070,10487,10583,05974020,11.4,8.0,3.4,2.9,7.0,2096,1475,621,2405,1679,726,9.9,"8.7,10.1,9.9,10.7,11.1,11.5,11.5,11.8,12.4,12.3,12.0,12.2,11.4","7.2,7.9,7.7,8.1,8.3,8.4,8.5,8.5,8.6,8.4,8.6,8.8,8.0","1.5,2.2,2.1,2.6,2.8,3.1,3.0,3.3,3.8,3.9,3.3,3.5,3.4","geseke, stadt"
05974024,12027,6044,5983,05974024,11.2,7.7,3.5,2.8,6.2,1085,751,334,1349,931,418,9.0,"7.6,8.7,8.9,9.7,10.0,9.9,10.2,10.3,10.9,11.1,11.6,11.7,11.2","6.4,7.1,7.2,7.7,7.7,7.4,7.5,7.7,8.0,7.7,8.2,8.3,7.7","1.2,1.6,1.7,2.0,2.3,2.5,2.7,2.6,2.9,3.4,3.3,3.4,3.5",lippetal
05974028,67233,33073,34160,05974028,10.8,7.4,3.5,3.5,7.6,7481,5140,2341,7278,4954,2324,11.1,"9.0,10.0,9.8,10.4,10.4,10.7,10.8,10.9,11.1,11.1,11.2,11.3,10.8","7.2,7.5,7.3,7.6,7.5,7.6,7.8,7.7,7.6,7.6,7.9,7.9,7.4","1.8,2.4,2.5,2.7,2.8,3.1,3.1,3.3,3.5,3.5,3.4,3.4,3.5","lippstadt, stadt"
05974032,11608,5987,5621,05974032,10.1,7.3,2.9,4.0,10.4,1673,1210,463,1178,844,334,14.4,"7.7,8.9,9.6,10.1,10.5,10.8,11.2,11.0,11.5,11.4,11.2,11.1,10.1","6.5,7.0,7.3,7.6,7.7,7.9,8.3,7.8,8.1,7.9,8.0,8.0,7.3","1.2,1.9,2.3,2.5,2.8,3.0,3.0,3.2,3.4,3.5,3.2,3.0,2.9",möhnesee
05974036,11095,5790,5305,05974036,10.9,7.5,3.4,2.5,5.0,833,558,275,1211,830,381,7.5,"8.1,9.5,9.5,9.9,10.3,10.6,11.0,11.3,12.0,11.7,11.8,11.4,10.9","6.8,7.5,7.4,7.6,7.5,7.5,7.9,7.9,8.2,8.2,8.4,8.0,7.5","1.4,2.0,2.1,2.4,2.8,3.1,3.1,3.3,3.8,3.5,3.4,3.3,3.4","rüthen, stadt"
05974040,47974,23245,24729,05974040,10.8,7.7,3.1,3.3,8.5,5632,4072,1560,5184,3684,1500,11.7,"8.4,9.7,9.8,10.4,10.5,10.6,10.8,11.0,11.1,11.5,11.2,11.5,10.8","6.8,7.4,7.6,7.8,7.8,7.5,7.7,7.8,7.6,7.8,8.0,8.3,7.7","1.6,2.3,2.3,2.5,2.7,3.1,3.1,3.3,3.5,3.7,3.2,3.3,3.1","soest, stadt"
05974044,25407,12721,12686,05974044,9.9,7.0,2.9,2.6,5.9,2150,1495,655,2518,1781,737,8.5,"7.4,8.6,8.4,9.0,9.4,9.3,9.4,9.7,9.9,10.3,10.2,10.2,9.9","6.0,6.5,6.6,6.9,6.9,6.7,6.9,7.0,6.9,7.2,7.4,7.4,7.0","1.3,2.0,1.8,2.1,2.5,2.6,2.6,2.7,3.0,3.1,2.8,2.8,2.9","warstein, stadt"
05974048,12140,6071,6069,05974048,9.6,6.6,3.0,1.7,3.5,638,428,210,1164,804,360,5.3,"7.2,8.2,8.7,8.8,9.2,9.5,9.8,9.9,9.9,9.9,9.7,10.4,9.6","6.1,6.4,6.8,6.9,7.0,7.1,7.3,7.4,7.0,7.1,7.1,7.4,6.6","1.1,1.8,1.9,1.9,2.2,2.4,2.5,2.6,2.9,2.8,2.7,3.0,3.0",welver
05974052,30638,15681,14957,05974052,11.1,7.9,3.2,2.8,7.0,2977,2134,843,3397,2417,980,9.7,"8.2,9.4,9.3,10.2,10.6,10.7,11.0,11.3,11.0,11.6,11.5,11.7,11.1","6.9,7.3,7.1,7.8,7.8,7.8,8.0,8.1,7.9,8.1,8.2,8.5,7.9","1.4,2.1,2.2,2.4,2.8,2.9,3.1,3.2,3.1,3.5,3.3,3.2,3.2","werl, stadt"
05974056,12745,6629,6116,05974056,10.9,7.4,3.5,3.2,6.3,1205,801,404,1386,937,449,9.5,"8.5,10.3,9.8,10.8,11.3,11.5,11.7,12.0,12.4,12.6,12.6,11.8,10.9","7.2,7.7,7.5,8.2,8.3,8.4,8.4,8.6,8.6,8.8,9.0,8.2,7.4","1.3,2.6,2.3,2.6,3.0,3.1,3.3,3.4,3.8,3.9,3.7,3.6,3.5",wickede (ruhr)
05978004,47803,23562,24241,05978004,10.3,8.1,2.2,1.5,5.3,3283,2547,736,4924,3850,1074,6.9,"7.4,8.5,8.4,8.9,9.2,9.4,9.4,9.8,10.0,10.2,10.2,10.3,10.3","6.4,7.1,6.8,7.1,7.2,7.2,7.2,7.5,7.7,7.8,8.1,8.2,8.1","1.0,1.5,1.6,1.8,2.0,2.2,2.2,2.2,2.3,2.4,2.1,2.1,2.2","bergkamen, stadt"
05978008,18059,8790,9269,05978008,9.0,6.8,2.1,2.1,4.8,1245,858,387,1621,1234,387,6.9,"6.6,7.5,7.7,8.0,8.3,8.7,8.8,9.3,9.3,9.3,9.1,9.5,9.0","5.7,6.2,6.3,6.3,6.4,6.7,6.8,7.1,7.1,7.0,7.1,7.3,6.8","0.9,1.3,1.4,1.7,1.9,2.0,2.0,2.1,2.2,2.3,2.0,2.2,2.1",bönen
05978012,20961,10293,10668,05978012,9.7,7.0,2.7,2.2,5.5,1607,1147,460,2037,1471,566,7.7,"7.2,8.3,8.3,8.5,9.0,9.1,9.1,9.1,9.4,9.9,9.8,10.0,9.7","6.0,6.5,6.4,6.5,6.8,6.8,6.8,6.7,6.7,7.0,7.2,7.3,7.0","1.1,1.8,1.8,2.0,2.2,2.2,2.3,2.4,2.6,2.8,2.6,2.7,2.7","fröndenberg/ruhr, stadt"
05978016,17085,8310,8775,05978016,9.2,6.6,2.5,2.5,10.0,2144,1710,434,1564,1130,434,12.5,"7.1,8.3,8.3,8.8,9.1,9.6,9.7,9.6,9.6,9.8,9.9,9.9,9.2","6.0,6.6,6.6,6.5,6.7,7.0,7.1,7.0,6.9,7.0,7.2,7.1,6.6","1.0,1.7,1.7,2.3,2.4,2.6,2.6,2.6,2.7,2.8,2.7,2.7,2.5",holzwickede
05978020,43868,21485,22383,05978020,8.9,6.7,2.2,2.2,6.7,3888,2920,968,3926,2945,981,8.9,"6.7,7.7,7.7,8.2,8.5,8.8,9.0,9.3,9.5,9.4,9.3,9.4,8.9","5.7,6.2,6.2,6.5,6.6,6.8,6.8,7.0,7.2,7.0,7.3,7.2,6.7","1.0,1.6,1.5,1.7,1.9,2.0,2.2,2.3,2.3,2.5,2.0,2.2,2.2","kamen, stadt"
05978024,85867,41810,44057,05978024,9.2,7.0,2.2,2.1,6.5,7386,5590,1796,7900,6024,1876,8.6,"7.1,8.2,8.2,8.4,8.6,8.7,9.0,9.1,9.2,9.3,9.3,9.4,9.2","6.2,6.8,6.7,6.8,6.8,6.8,7.0,7.1,7.1,7.1,7.3,7.3,7.0","0.9,1.4,1.5,1.7,1.8,1.9,2.0,2.0,2.1,2.2,1.9,2.0,2.2","lünen, stadt"
05978028,46723,22767,23956,05978028,8.9,6.4,2.5,2.2,5.8,3726,2715,1011,4145,2983,1162,8.0,"7.0,8.0,8.3,8.7,8.9,9.0,9.1,9.3,9.2,9.8,9.5,9.4,8.9","5.9,6.3,6.5,6.7,6.7,6.6,6.5,6.7,6.7,7.0,7.1,6.9,6.4","1.1,1.7,1.8,2.0,2.2,2.4,2.5,2.6,2.6,2.8,2.4,2.4,2.5","schwerte, hansestadt an der ruhr"
05978032,26603,13272,13331,05978032,9.8,7.3,2.5,2.2,6.5,2325,1733,592,2607,1930,677,8.7,"7.7,8.6,8.7,9.0,9.3,9.6,9.9,10.1,10.2,10.4,10.6,10.4,9.8","6.5,7.0,7.0,7.0,7.3,7.4,7.7,7.6,7.4,7.6,8.0,7.7,7.3","1.1,1.6,1.7,1.9,2.0,2.1,2.2,2.5,2.8,2.9,2.7,2.7,2.5","selm, stadt"
05978036,59111,28581,30530,05978036,9.6,6.9,2.7,2.8,7.5,6138,4462,1676,5651,4059,1592,10.4,"6.6,7.7,7.9,8.2,8.3,8.7,9.0,9.1,9.2,10.1,10.0,9.9,9.6","5.5,6.0,6.1,6.3,6.3,6.5,6.6,6.6,6.6,7.2,7.3,7.2,6.9","1.1,1.7,1.7,2.0,2.0,2.2,2.4,2.5,2.6,2.9,2.7,2.7,2.7","unna, stadt"
05978040,29955,14568,15387,05978040,9.4,6.9,2.5,2.5,6.9,2823,2081,742,2826,2076,750,9.4,"7.5,8.6,8.7,9.1,9.2,9.5,9.5,9.8,9.9,10.2,9.9,9.8,9.4","6.3,6.9,6.9,7.1,7.2,7.2,7.1,7.4,7.4,7.4,7.4,7.3,6.9","1.1,1.7,1.8,2.0,2.0,2.3,2.4,2.4,2.5,2.8,2.6,2.5,2.5","werne, stadt"
